"","game_id","game_date","home_team","away_team","home_score","away_score","point_differential","season"
"1","1999_01_ARI_PHI",1999-09-12,"PHI","ARI",24,25,-1,"1999"
"2","1999_01_BUF_IND",1999-09-12,"IND","BUF",31,14,17,"1999"
"3","1999_01_CAR_NO",1999-09-12,"NO","CAR",19,10,9,"1999"
"4","1999_01_CIN_TEN",1999-09-12,"TEN","CIN",36,35,1,"1999"
"5","1999_01_DAL_WAS",1999-09-12,"WAS","DAL",35,41,-6,"1999"
"6","1999_01_DET_SEA",1999-09-12,"SEA","DET",20,28,-8,"1999"
"7","1999_01_KC_CHI",1999-09-12,"CHI","KC",20,17,3,"1999"
"8","1999_01_MIA_DEN",1999-09-13,"DEN","MIA",21,38,-17,"1999"
"9","1999_01_MIN_ATL",1999-09-12,"ATL","MIN",14,17,-3,"1999"
"10","1999_01_NE_NYJ",1999-09-12,"NYJ","NE",28,30,-2,"1999"
"11","1999_01_NYG_TB",1999-09-12,"TB","NYG",13,17,-4,"1999"
"12","1999_01_OAK_GB",1999-09-12,"GB","LV",28,24,4,"1999"
"13","1999_01_PIT_CLE",1999-09-12,"CLE","PIT",0,43,-43,"1999"
"14","1999_01_SF_JAX",1999-09-12,"JAX","SF",41,3,38,"1999"
"15","1999_02_ARI_MIA",1999-09-19,"MIA","ARI",19,16,3,"1999"
"16","1999_02_ATL_DAL",1999-09-20,"DAL","ATL",24,7,17,"1999"
"17","1999_02_CLE_TEN",1999-09-19,"TEN","CLE",26,9,17,"1999"
"18","1999_02_DEN_KC",1999-09-19,"KC","DEN",26,10,16,"1999"
"19","1999_02_GB_DET",1999-09-19,"DET","GB",23,15,8,"1999"
"20","1999_02_IND_NE",1999-09-19,"NE","IND",31,28,3,"1999"
"21","1999_02_JAX_CAR",1999-09-19,"CAR","JAX",20,22,-2,"1999"
"22","1999_02_NO_SF",1999-09-19,"SF","NO",28,21,7,"1999"
"23","1999_02_NYJ_BUF",1999-09-19,"BUF","NYJ",17,3,14,"1999"
"24","1999_02_OAK_MIN",1999-09-19,"MIN","LV",17,22,-5,"1999"
"25","1999_02_PIT_BAL",1999-09-19,"BAL","PIT",20,23,-3,"1999"
"26","1999_02_SD_CIN",1999-09-19,"CIN","LAC",7,34,-27,"1999"
"27","1999_02_SEA_CHI",1999-09-19,"CHI","SEA",13,14,-1,"1999"
"28","1999_02_TB_PHI",1999-09-19,"PHI","TB",5,19,-14,"1999"
"29","1999_02_WAS_NYG",1999-09-19,"NYG","WAS",21,50,-29,"1999"
"30","1999_03_ATL_STL",1999-09-26,"LA","ATL",35,7,28,"1999"
"31","1999_03_CHI_OAK",1999-09-26,"LV","CHI",24,17,7,"1999"
"32","1999_03_CIN_CAR",1999-09-26,"CAR","CIN",27,3,24,"1999"
"33","1999_03_CLE_BAL",1999-09-26,"BAL","CLE",17,10,7,"1999"
"34","1999_03_DEN_TB",1999-09-26,"TB","DEN",13,10,3,"1999"
"35","1999_03_DET_KC",1999-09-26,"KC","DET",31,21,10,"1999"
"36","1999_03_IND_SD",1999-09-26,"LAC","IND",19,27,-8,"1999"
"37","1999_03_MIN_GB",1999-09-26,"GB","MIN",23,20,3,"1999"
"38","1999_03_NYG_NE",1999-09-26,"NE","NYG",16,14,2,"1999"
"39","1999_03_PHI_BUF",1999-09-26,"BUF","PHI",26,0,26,"1999"
"40","1999_03_SEA_PIT",1999-09-26,"PIT","SEA",10,29,-19,"1999"
"41","1999_03_SF_ARI",1999-09-27,"ARI","SF",10,24,-14,"1999"
"42","1999_03_TEN_JAX",1999-09-26,"JAX","TEN",19,20,-1,"1999"
"43","1999_03_WAS_NYJ",1999-09-26,"NYJ","WAS",20,27,-7,"1999"
"44","1999_04_ARI_DAL",1999-10-03,"DAL","ARI",35,7,28,"1999"
"45","1999_04_BAL_ATL",1999-10-03,"ATL","BAL",13,19,-6,"1999"
"46","1999_04_BUF_MIA",1999-10-04,"MIA","BUF",18,23,-5,"1999"
"47","1999_04_CAR_WAS",1999-10-03,"WAS","CAR",38,36,2,"1999"
"48","1999_04_JAX_PIT",1999-10-03,"PIT","JAX",3,17,-14,"1999"
"49","1999_04_KC_SD",1999-10-03,"LAC","KC",21,14,7,"1999"
"50","1999_04_NE_CLE",1999-10-03,"CLE","NE",7,19,-12,"1999"
"51","1999_04_NO_CHI",1999-10-03,"CHI","NO",14,10,4,"1999"
"52","1999_04_NYJ_DEN",1999-10-03,"DEN","NYJ",13,21,-8,"1999"
"53","1999_04_OAK_SEA",1999-10-03,"SEA","LV",22,21,1,"1999"
"54","1999_04_PHI_NYG",1999-10-03,"NYG","PHI",16,15,1,"1999"
"55","1999_04_STL_CIN",1999-10-03,"CIN","LA",10,38,-28,"1999"
"56","1999_04_TB_MIN",1999-10-03,"MIN","TB",21,14,7,"1999"
"57","1999_04_TEN_SF",1999-10-03,"SF","TEN",24,22,2,"1999"
"58","1999_05_ATL_NO",1999-10-10,"NO","ATL",17,20,-3,"1999"
"59","1999_05_BAL_TEN",1999-10-10,"TEN","BAL",14,11,3,"1999"
"60","1999_05_CHI_MIN",1999-10-10,"MIN","CHI",22,24,-2,"1999"
"61","1999_05_CIN_CLE",1999-10-10,"CLE","CIN",17,18,-1,"1999"
"62","1999_05_DAL_PHI",1999-10-10,"PHI","DAL",13,10,3,"1999"
"63","1999_05_DEN_OAK",1999-10-10,"LV","DEN",13,16,-3,"1999"
"64","1999_05_JAX_NYJ",1999-10-11,"NYJ","JAX",6,16,-10,"1999"
"65","1999_05_MIA_IND",1999-10-10,"IND","MIA",31,34,-3,"1999"
"66","1999_05_NE_KC",1999-10-10,"KC","NE",16,14,2,"1999"
"67","1999_05_NYG_ARI",1999-10-10,"ARI","NYG",14,3,11,"1999"
"68","1999_05_PIT_BUF",1999-10-10,"BUF","PIT",24,21,3,"1999"
"69","1999_05_SD_DET",1999-10-10,"DET","LAC",10,20,-10,"1999"
"70","1999_05_SF_STL",1999-10-10,"LA","SF",42,20,22,"1999"
"71","1999_05_TB_GB",1999-10-10,"GB","TB",26,23,3,"1999"
"72","1999_06_CAR_SF",1999-10-17,"SF","CAR",29,31,-2,"1999"
"73","1999_06_CLE_JAX",1999-10-17,"JAX","CLE",24,7,17,"1999"
"74","1999_06_DAL_NYG",1999-10-18,"NYG","DAL",13,10,3,"1999"
"75","1999_06_GB_DEN",1999-10-17,"DEN","GB",31,10,21,"1999"
"76","1999_06_IND_NYJ",1999-10-17,"NYJ","IND",13,16,-3,"1999"
"77","1999_06_MIA_NE",1999-10-17,"NE","MIA",30,31,-1,"1999"
"78","1999_06_MIN_DET",1999-10-17,"DET","MIN",25,23,2,"1999"
"79","1999_06_OAK_BUF",1999-10-17,"BUF","LV",14,20,-6,"1999"
"80","1999_06_PHI_CHI",1999-10-17,"CHI","PHI",16,20,-4,"1999"
"81","1999_06_PIT_CIN",1999-10-17,"CIN","PIT",3,17,-14,"1999"
"82","1999_06_SEA_SD",1999-10-17,"LAC","SEA",13,10,3,"1999"
"83","1999_06_STL_ATL",1999-10-17,"ATL","LA",13,41,-28,"1999"
"84","1999_06_TEN_NO",1999-10-17,"NO","TEN",21,24,-3,"1999"
"85","1999_06_WAS_ARI",1999-10-17,"ARI","WAS",10,24,-14,"1999"
"86","1999_07_ATL_PIT",1999-10-25,"PIT","ATL",13,9,4,"1999"
"87","1999_07_BUF_SEA",1999-10-24,"SEA","BUF",26,16,10,"1999"
"88","1999_07_CHI_TB",1999-10-24,"TB","CHI",6,3,3,"1999"
"89","1999_07_CIN_IND",1999-10-24,"IND","CIN",31,10,21,"1999"
"90","1999_07_CLE_STL",1999-10-24,"LA","CLE",34,3,31,"1999"
"91","1999_07_DEN_NE",1999-10-24,"NE","DEN",24,23,1,"1999"
"92","1999_07_DET_CAR",1999-10-24,"CAR","DET",9,24,-15,"1999"
"93","1999_07_GB_SD",1999-10-24,"LAC","GB",3,31,-28,"1999"
"94","1999_07_KC_BAL",1999-10-21,"BAL","KC",8,35,-27,"1999"
"95","1999_07_NO_NYG",1999-10-24,"NYG","NO",31,3,28,"1999"
"96","1999_07_NYJ_OAK",1999-10-24,"LV","NYJ",24,23,1,"1999"
"97","1999_07_PHI_MIA",1999-10-24,"MIA","PHI",16,13,3,"1999"
"98","1999_07_SF_MIN",1999-10-24,"MIN","SF",40,16,24,"1999"
"99","1999_07_WAS_DAL",1999-10-24,"DAL","WAS",38,20,18,"1999"
"100","1999_08_BUF_BAL",1999-10-31,"BAL","BUF",10,13,-3,"1999"
"101","1999_08_CAR_ATL",1999-10-31,"ATL","CAR",27,20,7,"1999"
"102","1999_08_CHI_WAS",1999-10-31,"WAS","CHI",48,22,26,"1999"
"103","1999_08_CLE_NO",1999-10-31,"NO","CLE",16,21,-5,"1999"
"104","1999_08_DAL_IND",1999-10-31,"IND","DAL",34,24,10,"1999"
"105","1999_08_JAX_CIN",1999-10-31,"CIN","JAX",10,41,-31,"1999"
"106","1999_08_MIA_OAK",1999-10-31,"LV","MIA",9,16,-7,"1999"
"107","1999_08_MIN_DEN",1999-10-31,"DEN","MIN",20,23,-3,"1999"
"108","1999_08_NE_ARI",1999-10-31,"ARI","NE",3,27,-24,"1999"
"109","1999_08_NYG_PHI",1999-10-31,"PHI","NYG",17,23,-6,"1999"
"110","1999_08_SD_KC",1999-10-31,"KC","LAC",34,0,34,"1999"
"111","1999_08_SEA_GB",1999-11-01,"GB","SEA",7,27,-20,"1999"
"112","1999_08_STL_TEN",1999-10-31,"TEN","LA",24,21,3,"1999"
"113","1999_08_TB_DET",1999-10-31,"DET","TB",20,3,17,"1999"
"114","1999_09_ARI_NYJ",1999-11-07,"NYJ","ARI",12,7,5,"1999"
"115","1999_09_BAL_CLE",1999-11-07,"CLE","BAL",9,41,-32,"1999"
"116","1999_09_BUF_WAS",1999-11-07,"WAS","BUF",17,34,-17,"1999"
"117","1999_09_CHI_GB",1999-11-07,"GB","CHI",13,14,-1,"1999"
"118","1999_09_CIN_SEA",1999-11-07,"SEA","CIN",37,20,17,"1999"
"119","1999_09_DAL_MIN",1999-11-08,"MIN","DAL",27,17,10,"1999"
"120","1999_09_DEN_SD",1999-11-07,"LAC","DEN",17,33,-16,"1999"
"121","1999_09_JAX_ATL",1999-11-07,"ATL","JAX",7,30,-23,"1999"
"122","1999_09_KC_IND",1999-11-07,"IND","KC",25,17,8,"1999"
"123","1999_09_PHI_CAR",1999-11-07,"CAR","PHI",33,7,26,"1999"
"124","1999_09_PIT_SF",1999-11-07,"SF","PIT",6,27,-21,"1999"
"125","1999_09_STL_DET",1999-11-07,"DET","LA",31,27,4,"1999"
"126","1999_09_TB_NO",1999-11-07,"NO","TB",16,31,-15,"1999"
"127","1999_09_TEN_MIA",1999-11-07,"MIA","TEN",17,0,17,"1999"
"128","1999_10_BAL_JAX",1999-11-14,"JAX","BAL",6,3,3,"1999"
"129","1999_10_CAR_STL",1999-11-14,"LA","CAR",35,10,25,"1999"
"130","1999_10_CLE_PIT",1999-11-14,"PIT","CLE",15,16,-1,"1999"
"131","1999_10_DEN_SEA",1999-11-14,"SEA","DEN",20,17,3,"1999"
"132","1999_10_DET_ARI",1999-11-14,"ARI","DET",23,19,4,"1999"
"133","1999_10_GB_DAL",1999-11-14,"DAL","GB",27,13,14,"1999"
"134","1999_10_IND_NYG",1999-11-14,"NYG","IND",19,27,-8,"1999"
"135","1999_10_KC_TB",1999-11-14,"TB","KC",17,10,7,"1999"
"136","1999_10_MIA_BUF",1999-11-14,"BUF","MIA",23,3,20,"1999"
"137","1999_10_MIN_CHI",1999-11-14,"CHI","MIN",24,27,-3,"1999"
"138","1999_10_NYJ_NE",1999-11-15,"NE","NYJ",17,24,-7,"1999"
"139","1999_10_SD_OAK",1999-11-14,"LV","LAC",28,9,19,"1999"
"140","1999_10_SF_NO",1999-11-14,"NO","SF",24,6,18,"1999"
"141","1999_10_TEN_CIN",1999-11-14,"CIN","TEN",14,24,-10,"1999"
"142","1999_10_WAS_PHI",1999-11-14,"PHI","WAS",35,28,7,"1999"
"143","1999_11_ATL_TB",1999-11-21,"TB","ATL",19,10,9,"1999"
"144","1999_11_BAL_CIN",1999-11-21,"CIN","BAL",31,34,-3,"1999"
"145","1999_11_BUF_NYJ",1999-11-21,"NYJ","BUF",17,7,10,"1999"
"146","1999_11_CAR_CLE",1999-11-21,"CLE","CAR",17,31,-14,"1999"
"147","1999_11_CHI_SD",1999-11-21,"LAC","CHI",20,23,-3,"1999"
"148","1999_11_DAL_ARI",1999-11-21,"ARI","DAL",13,9,4,"1999"
"149","1999_11_DET_GB",1999-11-21,"GB","DET",26,17,9,"1999"
"150","1999_11_IND_PHI",1999-11-21,"PHI","IND",17,44,-27,"1999"
"151","1999_11_NE_MIA",1999-11-21,"MIA","NE",27,17,10,"1999"
"152","1999_11_NO_JAX",1999-11-21,"JAX","NO",41,23,18,"1999"
"153","1999_11_NYG_WAS",1999-11-21,"WAS","NYG",23,13,10,"1999"
"154","1999_11_OAK_DEN",1999-11-22,"DEN","LV",27,21,6,"1999"
"155","1999_11_PIT_TEN",1999-11-21,"TEN","PIT",16,10,6,"1999"
"156","1999_11_SEA_KC",1999-11-21,"KC","SEA",19,31,-12,"1999"
"157","1999_11_STL_SF",1999-11-21,"SF","LA",7,23,-16,"1999"
"158","1999_12_ARI_NYG",1999-11-28,"NYG","ARI",24,34,-10,"1999"
"159","1999_12_ATL_CAR",1999-11-28,"CAR","ATL",34,28,6,"1999"
"160","1999_12_CHI_DET",1999-11-25,"DET","CHI",21,17,4,"1999"
"161","1999_12_CIN_PIT",1999-11-28,"PIT","CIN",20,27,-7,"1999"
"162","1999_12_GB_SF",1999-11-29,"SF","GB",3,20,-17,"1999"
"163","1999_12_JAX_BAL",1999-11-28,"BAL","JAX",23,30,-7,"1999"
"164","1999_12_KC_OAK",1999-11-28,"LV","KC",34,37,-3,"1999"
"165","1999_12_MIA_DAL",1999-11-25,"DAL","MIA",20,0,20,"1999"
"166","1999_12_NE_BUF",1999-11-28,"BUF","NE",17,7,10,"1999"
"167","1999_12_NO_STL",1999-11-28,"LA","NO",43,12,31,"1999"
"168","1999_12_NYJ_IND",1999-11-28,"IND","NYJ",13,6,7,"1999"
"169","1999_12_PHI_WAS",1999-11-28,"WAS","PHI",20,17,3,"1999"
"170","1999_12_SD_MIN",1999-11-28,"MIN","LAC",35,27,8,"1999"
"171","1999_12_TB_SEA",1999-11-28,"SEA","TB",3,16,-13,"1999"
"172","1999_12_TEN_CLE",1999-11-28,"CLE","TEN",21,33,-12,"1999"
"173","1999_13_CLE_SD",1999-12-05,"LAC","CLE",23,10,13,"1999"
"174","1999_13_DAL_NE",1999-12-05,"NE","DAL",13,6,7,"1999"
"175","1999_13_GB_CHI",1999-12-05,"CHI","GB",19,35,-16,"1999"
"176","1999_13_IND_MIA",1999-12-05,"MIA","IND",34,37,-3,"1999"
"177","1999_13_KC_DEN",1999-12-05,"DEN","KC",10,16,-6,"1999"
"178","1999_13_MIN_TB",1999-12-06,"TB","MIN",24,17,7,"1999"
"179","1999_13_NO_ATL",1999-12-05,"ATL","NO",35,12,23,"1999"
"180","1999_13_NYJ_NYG",1999-12-05,"NYG","NYJ",41,28,13,"1999"
"181","1999_13_PHI_ARI",1999-12-05,"ARI","PHI",21,17,4,"1999"
"182","1999_13_PIT_JAX",1999-12-02,"JAX","PIT",20,6,14,"1999"
"183","1999_13_SEA_OAK",1999-12-05,"LV","SEA",30,21,9,"1999"
"184","1999_13_SF_CIN",1999-12-05,"CIN","SF",44,30,14,"1999"
"185","1999_13_STL_CAR",1999-12-05,"CAR","LA",21,34,-13,"1999"
"186","1999_13_TEN_BAL",1999-12-05,"BAL","TEN",41,14,27,"1999"
"187","1999_13_WAS_DET",1999-12-05,"DET","WAS",33,17,16,"1999"
"188","1999_14_ARI_WAS",1999-12-12,"WAS","ARI",28,3,25,"1999"
"189","1999_14_ATL_SF",1999-12-12,"SF","ATL",26,7,19,"1999"
"190","1999_14_BAL_PIT",1999-12-12,"PIT","BAL",24,31,-7,"1999"
"191","1999_14_CAR_GB",1999-12-12,"GB","CAR",31,33,-2,"1999"
"192","1999_14_CLE_CIN",1999-12-12,"CIN","CLE",44,28,16,"1999"
"193","1999_14_DEN_JAX",1999-12-13,"JAX","DEN",27,24,3,"1999"
"194","1999_14_DET_TB",1999-12-12,"TB","DET",23,16,7,"1999"
"195","1999_14_MIA_NYJ",1999-12-12,"NYJ","MIA",28,20,8,"1999"
"196","1999_14_MIN_KC",1999-12-12,"KC","MIN",31,28,3,"1999"
"197","1999_14_NE_IND",1999-12-12,"IND","NE",20,15,5,"1999"
"198","1999_14_NYG_BUF",1999-12-12,"BUF","NYG",17,19,-2,"1999"
"199","1999_14_OAK_TEN",1999-12-09,"TEN","LV",21,14,7,"1999"
"200","1999_14_PHI_DAL",1999-12-12,"DAL","PHI",20,10,10,"1999"
"201","1999_14_SD_SEA",1999-12-12,"SEA","LAC",16,19,-3,"1999"
"202","1999_14_STL_NO",1999-12-12,"NO","LA",14,30,-16,"1999"
"203","1999_15_ATL_TEN",1999-12-19,"TEN","ATL",30,17,13,"1999"
"204","1999_15_BUF_ARI",1999-12-19,"ARI","BUF",21,31,-10,"1999"
"205","1999_15_DET_CHI",1999-12-19,"CHI","DET",28,10,18,"1999"
"206","1999_15_GB_MIN",1999-12-20,"MIN","GB",24,20,4,"1999"
"207","1999_15_JAX_CLE",1999-12-19,"CLE","JAX",14,24,-10,"1999"
"208","1999_15_NE_PHI",1999-12-19,"PHI","NE",24,9,15,"1999"
"209","1999_15_NO_BAL",1999-12-19,"BAL","NO",31,8,23,"1999"
"210","1999_15_NYG_STL",1999-12-19,"LA","NYG",31,10,21,"1999"
"211","1999_15_NYJ_DAL",1999-12-19,"DAL","NYJ",21,22,-1,"1999"
"212","1999_15_PIT_KC",1999-12-18,"KC","PIT",35,19,16,"1999"
"213","1999_15_SD_MIA",1999-12-19,"MIA","LAC",12,9,3,"1999"
"214","1999_15_SEA_DEN",1999-12-19,"DEN","SEA",36,30,6,"1999"
"215","1999_15_SF_CAR",1999-12-18,"CAR","SF",41,24,17,"1999"
"216","1999_15_TB_OAK",1999-12-19,"LV","TB",45,0,45,"1999"
"217","1999_15_WAS_IND",1999-12-19,"IND","WAS",24,21,3,"1999"
"218","1999_16_ARI_ATL",1999-12-26,"ATL","ARI",37,14,23,"1999"
"219","1999_16_BUF_NE",1999-12-26,"NE","BUF",10,13,-3,"1999"
"220","1999_16_CAR_PIT",1999-12-26,"PIT","CAR",30,20,10,"1999"
"221","1999_16_CHI_STL",1999-12-26,"LA","CHI",34,12,22,"1999"
"222","1999_16_CIN_BAL",1999-12-26,"BAL","CIN",22,0,22,"1999"
"223","1999_16_DAL_NO",1999-12-24,"NO","DAL",31,24,7,"1999"
"224","1999_16_DEN_DET",1999-12-25,"DET","DEN",7,17,-10,"1999"
"225","1999_16_GB_TB",1999-12-26,"TB","GB",29,10,19,"1999"
"226","1999_16_IND_CLE",1999-12-26,"CLE","IND",28,29,-1,"1999"
"227","1999_16_JAX_TEN",1999-12-26,"TEN","JAX",41,14,27,"1999"
"228","1999_16_KC_SEA",1999-12-26,"SEA","KC",23,14,9,"1999"
"229","1999_16_MIN_NYG",1999-12-26,"NYG","MIN",17,34,-17,"1999"
"230","1999_16_NYJ_MIA",1999-12-27,"MIA","NYJ",31,38,-7,"1999"
"231","1999_16_OAK_SD",1999-12-26,"LAC","LV",23,20,3,"1999"
"232","1999_16_WAS_SF",1999-12-26,"SF","WAS",20,26,-6,"1999"
"233","2000_01_ARI_NYG",2000-09-03,"NYG","ARI",21,16,5,"2000"
"234","2000_01_BAL_PIT",2000-09-03,"PIT","BAL",0,16,-16,"2000"
"235","2000_01_CAR_WAS",2000-09-03,"WAS","CAR",20,17,3,"2000"
"236","2000_01_CHI_MIN",2000-09-03,"MIN","CHI",30,27,3,"2000"
"237","2000_01_DEN_STL",2000-09-04,"LA","DEN",41,36,5,"2000"
"238","2000_01_DET_NO",2000-09-03,"NO","DET",10,14,-4,"2000"
"239","2000_01_IND_KC",2000-09-03,"KC","IND",14,27,-13,"2000"
"240","2000_01_JAX_CLE",2000-09-03,"CLE","JAX",7,27,-20,"2000"
"241","2000_01_NYJ_GB",2000-09-03,"GB","NYJ",16,20,-4,"2000"
"242","2000_01_PHI_DAL",2000-09-03,"DAL","PHI",14,41,-27,"2000"
"243","2000_01_SD_OAK",2000-09-03,"LV","LAC",9,6,3,"2000"
"244","2000_01_SEA_MIA",2000-09-03,"MIA","SEA",23,0,23,"2000"
"245","2000_01_SF_ATL",2000-09-03,"ATL","SF",36,28,8,"2000"
"246","2000_01_TB_NE",2000-09-03,"NE","TB",16,21,-5,"2000"
"247","2000_01_TEN_BUF",2000-09-03,"BUF","TEN",16,13,3,"2000"
"248","2000_02_ATL_DEN",2000-09-10,"DEN","ATL",42,14,28,"2000"
"249","2000_02_CAR_SF",2000-09-10,"SF","CAR",22,38,-16,"2000"
"250","2000_02_CHI_TB",2000-09-10,"TB","CHI",41,0,41,"2000"
"251","2000_02_CLE_CIN",2000-09-10,"CIN","CLE",7,24,-17,"2000"
"252","2000_02_DAL_ARI",2000-09-10,"ARI","DAL",32,31,1,"2000"
"253","2000_02_GB_BUF",2000-09-10,"BUF","GB",27,18,9,"2000"
"254","2000_02_JAX_BAL",2000-09-10,"BAL","JAX",39,36,3,"2000"
"255","2000_02_KC_TEN",2000-09-10,"TEN","KC",17,14,3,"2000"
"256","2000_02_MIA_MIN",2000-09-10,"MIN","MIA",13,7,6,"2000"
"257","2000_02_NE_NYJ",2000-09-11,"NYJ","NE",20,19,1,"2000"
"258","2000_02_NO_SD",2000-09-10,"LAC","NO",27,28,-1,"2000"
"259","2000_02_NYG_PHI",2000-09-10,"PHI","NYG",18,33,-15,"2000"
"260","2000_02_OAK_IND",2000-09-10,"IND","LV",31,38,-7,"2000"
"261","2000_02_STL_SEA",2000-09-10,"SEA","LA",34,37,-3,"2000"
"262","2000_02_WAS_DET",2000-09-10,"DET","WAS",15,10,5,"2000"
"263","2000_03_ATL_CAR",2000-09-17,"CAR","ATL",10,15,-5,"2000"
"264","2000_03_BAL_MIA",2000-09-17,"MIA","BAL",19,6,13,"2000"
"265","2000_03_BUF_NYJ",2000-09-17,"NYJ","BUF",27,14,13,"2000"
"266","2000_03_CIN_JAX",2000-09-17,"JAX","CIN",13,0,13,"2000"
"267","2000_03_DAL_WAS",2000-09-18,"WAS","DAL",21,27,-6,"2000"
"268","2000_03_DEN_OAK",2000-09-17,"LV","DEN",24,33,-9,"2000"
"269","2000_03_MIN_NE",2000-09-17,"NE","MIN",13,21,-8,"2000"
"270","2000_03_NO_SEA",2000-09-17,"SEA","NO",20,10,10,"2000"
"271","2000_03_NYG_CHI",2000-09-17,"CHI","NYG",7,14,-7,"2000"
"272","2000_03_PHI_GB",2000-09-17,"GB","PHI",6,3,3,"2000"
"273","2000_03_PIT_CLE",2000-09-17,"CLE","PIT",23,20,3,"2000"
"274","2000_03_SF_STL",2000-09-17,"LA","SF",41,24,17,"2000"
"275","2000_03_TB_DET",2000-09-17,"DET","TB",10,31,-21,"2000"
"276","2000_04_CIN_BAL",2000-09-24,"BAL","CIN",37,0,37,"2000"
"277","2000_04_CLE_OAK",2000-09-24,"LV","CLE",36,10,26,"2000"
"278","2000_04_DET_CHI",2000-09-24,"CHI","DET",14,21,-7,"2000"
"279","2000_04_GB_ARI",2000-09-24,"ARI","GB",3,29,-26,"2000"
"280","2000_04_JAX_IND",2000-09-25,"IND","JAX",43,14,29,"2000"
"281","2000_04_KC_DEN",2000-09-24,"DEN","KC",22,23,-1,"2000"
"282","2000_04_NE_MIA",2000-09-24,"MIA","NE",10,3,7,"2000"
"283","2000_04_NYJ_TB",2000-09-24,"TB","NYJ",17,21,-4,"2000"
"284","2000_04_PHI_NO",2000-09-24,"NO","PHI",7,21,-14,"2000"
"285","2000_04_SEA_SD",2000-09-24,"LAC","SEA",12,20,-8,"2000"
"286","2000_04_SF_DAL",2000-09-24,"DAL","SF",24,41,-17,"2000"
"287","2000_04_STL_ATL",2000-09-24,"ATL","LA",20,41,-21,"2000"
"288","2000_04_TEN_PIT",2000-09-24,"PIT","TEN",20,23,-3,"2000"
"289","2000_04_WAS_NYG",2000-09-24,"NYG","WAS",6,16,-10,"2000"
"290","2000_05_ARI_SF",2000-10-01,"SF","ARI",27,20,7,"2000"
"291","2000_05_ATL_PHI",2000-10-01,"PHI","ATL",38,10,28,"2000"
"292","2000_05_BAL_CLE",2000-10-01,"CLE","BAL",0,12,-12,"2000"
"293","2000_05_CHI_GB",2000-10-01,"GB","CHI",24,27,-3,"2000"
"294","2000_05_DAL_CAR",2000-10-01,"CAR","DAL",13,16,-3,"2000"
"295","2000_05_IND_BUF",2000-10-01,"BUF","IND",16,18,-2,"2000"
"296","2000_05_MIA_CIN",2000-10-01,"CIN","MIA",16,31,-15,"2000"
"297","2000_05_MIN_DET",2000-10-01,"DET","MIN",24,31,-7,"2000"
"298","2000_05_NE_DEN",2000-10-01,"DEN","NE",19,28,-9,"2000"
"299","2000_05_NYG_TEN",2000-10-01,"TEN","NYG",28,14,14,"2000"
"300","2000_05_PIT_JAX",2000-10-01,"JAX","PIT",13,24,-11,"2000"
"301","2000_05_SD_STL",2000-10-01,"LA","LAC",57,31,26,"2000"
"302","2000_05_SEA_KC",2000-10-02,"KC","SEA",24,17,7,"2000"
"303","2000_05_TB_WAS",2000-10-01,"WAS","TB",20,17,3,"2000"
"304","2000_06_BAL_JAX",2000-10-08,"JAX","BAL",10,15,-5,"2000"
"305","2000_06_CLE_ARI",2000-10-08,"ARI","CLE",29,21,8,"2000"
"306","2000_06_DEN_SD",2000-10-08,"LAC","DEN",7,21,-14,"2000"
"307","2000_06_GB_DET",2000-10-08,"DET","GB",31,24,7,"2000"
"308","2000_06_IND_NE",2000-10-08,"NE","IND",24,16,8,"2000"
"309","2000_06_NO_CHI",2000-10-08,"CHI","NO",10,31,-21,"2000"
"310","2000_06_NYG_ATL",2000-10-08,"ATL","NYG",6,13,-7,"2000"
"311","2000_06_OAK_SF",2000-10-08,"SF","LV",28,34,-6,"2000"
"312","2000_06_PIT_NYJ",2000-10-08,"NYJ","PIT",3,20,-17,"2000"
"313","2000_06_SEA_CAR",2000-10-08,"CAR","SEA",26,3,23,"2000"
"314","2000_06_TB_MIN",2000-10-09,"MIN","TB",30,23,7,"2000"
"315","2000_06_TEN_CIN",2000-10-08,"CIN","TEN",14,23,-9,"2000"
"316","2000_06_WAS_PHI",2000-10-08,"PHI","WAS",14,17,-3,"2000"
"317","2000_07_ATL_STL",2000-10-15,"LA","ATL",45,29,16,"2000"
"318","2000_07_BAL_WAS",2000-10-15,"WAS","BAL",10,3,7,"2000"
"319","2000_07_CAR_NO",2000-10-15,"NO","CAR",24,6,18,"2000"
"320","2000_07_CIN_PIT",2000-10-15,"PIT","CIN",15,0,15,"2000"
"321","2000_07_CLE_DEN",2000-10-15,"DEN","CLE",44,10,34,"2000"
"322","2000_07_DAL_NYG",2000-10-15,"NYG","DAL",19,14,5,"2000"
"323","2000_07_IND_SEA",2000-10-15,"SEA","IND",24,37,-13,"2000"
"324","2000_07_JAX_TEN",2000-10-16,"TEN","JAX",27,13,14,"2000"
"325","2000_07_MIN_CHI",2000-10-15,"CHI","MIN",16,28,-12,"2000"
"326","2000_07_NYJ_NE",2000-10-15,"NE","NYJ",17,34,-17,"2000"
"327","2000_07_OAK_KC",2000-10-15,"KC","LV",17,20,-3,"2000"
"328","2000_07_PHI_ARI",2000-10-15,"ARI","PHI",14,33,-19,"2000"
"329","2000_07_SD_BUF",2000-10-15,"BUF","LAC",27,24,3,"2000"
"330","2000_07_SF_GB",2000-10-15,"GB","SF",31,28,3,"2000"
"331","2000_08_ARI_DAL",2000-10-22,"DAL","ARI",48,7,41,"2000"
"332","2000_08_BUF_MIN",2000-10-22,"MIN","BUF",31,27,4,"2000"
"333","2000_08_CHI_PHI",2000-10-22,"PHI","CHI",13,9,4,"2000"
"334","2000_08_CLE_PIT",2000-10-22,"PIT","CLE",22,0,22,"2000"
"335","2000_08_DEN_CIN",2000-10-22,"CIN","DEN",31,21,10,"2000"
"336","2000_08_DET_TB",2000-10-19,"TB","DET",14,28,-14,"2000"
"337","2000_08_MIA_NYJ",2000-10-23,"NYJ","MIA",40,37,3,"2000"
"338","2000_08_NE_IND",2000-10-22,"IND","NE",30,23,7,"2000"
"339","2000_08_NO_ATL",2000-10-22,"ATL","NO",19,21,-2,"2000"
"340","2000_08_SEA_OAK",2000-10-22,"LV","SEA",31,3,28,"2000"
"341","2000_08_SF_CAR",2000-10-22,"CAR","SF",34,16,18,"2000"
"342","2000_08_STL_KC",2000-10-22,"KC","LA",54,34,20,"2000"
"343","2000_08_TEN_BAL",2000-10-22,"BAL","TEN",6,14,-8,"2000"
"344","2000_08_WAS_JAX",2000-10-22,"JAX","WAS",16,35,-19,"2000"
"345","2000_09_CAR_ATL",2000-10-29,"ATL","CAR",13,12,1,"2000"
"346","2000_09_CIN_CLE",2000-10-29,"CLE","CIN",3,12,-9,"2000"
"347","2000_09_DET_IND",2000-10-29,"IND","DET",30,18,12,"2000"
"348","2000_09_GB_MIA",2000-10-29,"MIA","GB",28,20,8,"2000"
"349","2000_09_JAX_DAL",2000-10-29,"DAL","JAX",17,23,-6,"2000"
"350","2000_09_KC_SEA",2000-10-29,"SEA","KC",19,24,-5,"2000"
"351","2000_09_MIN_TB",2000-10-29,"TB","MIN",41,13,28,"2000"
"352","2000_09_NO_ARI",2000-10-29,"ARI","NO",10,21,-11,"2000"
"353","2000_09_NYJ_BUF",2000-10-29,"BUF","NYJ",23,20,3,"2000"
"354","2000_09_OAK_SD",2000-10-29,"LAC","LV",13,15,-2,"2000"
"355","2000_09_PHI_NYG",2000-10-29,"NYG","PHI",24,7,17,"2000"
"356","2000_09_PIT_BAL",2000-10-29,"BAL","PIT",6,9,-3,"2000"
"357","2000_09_STL_SF",2000-10-29,"SF","LA",24,34,-10,"2000"
"358","2000_09_TEN_WAS",2000-10-30,"WAS","TEN",21,27,-6,"2000"
"359","2000_10_BAL_CIN",2000-11-05,"CIN","BAL",7,27,-20,"2000"
"360","2000_10_BUF_NE",2000-11-05,"NE","BUF",13,16,-3,"2000"
"361","2000_10_CAR_STL",2000-11-05,"LA","CAR",24,27,-3,"2000"
"362","2000_10_DAL_PHI",2000-11-05,"PHI","DAL",16,13,3,"2000"
"363","2000_10_DEN_NYJ",2000-11-05,"NYJ","DEN",23,30,-7,"2000"
"364","2000_10_IND_CHI",2000-11-05,"CHI","IND",27,24,3,"2000"
"365","2000_10_KC_OAK",2000-11-05,"LV","KC",49,31,18,"2000"
"366","2000_10_MIA_DET",2000-11-05,"DET","MIA",8,23,-15,"2000"
"367","2000_10_MIN_GB",2000-11-06,"GB","MIN",26,20,6,"2000"
"368","2000_10_NYG_CLE",2000-11-05,"CLE","NYG",3,24,-21,"2000"
"369","2000_10_PIT_TEN",2000-11-05,"TEN","PIT",9,7,2,"2000"
"370","2000_10_SD_SEA",2000-11-05,"SEA","LAC",17,15,2,"2000"
"371","2000_10_SF_NO",2000-11-05,"NO","SF",31,15,16,"2000"
"372","2000_10_TB_ATL",2000-11-05,"ATL","TB",14,27,-13,"2000"
"373","2000_10_WAS_ARI",2000-11-05,"ARI","WAS",16,15,1,"2000"
"374","2000_11_ARI_MIN",2000-11-12,"MIN","ARI",31,14,17,"2000"
"375","2000_11_ATL_DET",2000-11-12,"DET","ATL",13,10,3,"2000"
"376","2000_11_BAL_TEN",2000-11-12,"TEN","BAL",23,24,-1,"2000"
"377","2000_11_CHI_BUF",2000-11-12,"BUF","CHI",20,3,17,"2000"
"378","2000_11_CIN_DAL",2000-11-12,"DAL","CIN",23,6,17,"2000"
"379","2000_11_GB_TB",2000-11-12,"TB","GB",20,15,5,"2000"
"380","2000_11_KC_SF",2000-11-12,"SF","KC",21,7,14,"2000"
"381","2000_11_MIA_SD",2000-11-12,"LAC","MIA",7,17,-10,"2000"
"382","2000_11_NE_CLE",2000-11-12,"CLE","NE",19,11,8,"2000"
"383","2000_11_NO_CAR",2000-11-12,"CAR","NO",10,20,-10,"2000"
"384","2000_11_NYJ_IND",2000-11-12,"IND","NYJ",23,15,8,"2000"
"385","2000_11_OAK_DEN",2000-11-13,"DEN","LV",24,36,-12,"2000"
"386","2000_11_PHI_PIT",2000-11-12,"PIT","PHI",23,26,-3,"2000"
"387","2000_11_SEA_JAX",2000-11-12,"JAX","SEA",21,28,-7,"2000"
"388","2000_11_STL_NYG",2000-11-12,"NYG","LA",24,38,-14,"2000"
"389","2000_12_ARI_PHI",2000-11-19,"PHI","ARI",34,9,25,"2000"
"390","2000_12_ATL_SF",2000-11-19,"SF","ATL",16,6,10,"2000"
"391","2000_12_BUF_KC",2000-11-19,"KC","BUF",17,21,-4,"2000"
"392","2000_12_CAR_MIN",2000-11-19,"MIN","CAR",31,17,14,"2000"
"393","2000_12_CIN_NE",2000-11-19,"NE","CIN",16,13,3,"2000"
"394","2000_12_CLE_TEN",2000-11-19,"TEN","CLE",24,10,14,"2000"
"395","2000_12_DAL_BAL",2000-11-19,"BAL","DAL",27,0,27,"2000"
"396","2000_12_DET_NYG",2000-11-19,"NYG","DET",21,31,-10,"2000"
"397","2000_12_IND_GB",2000-11-19,"GB","IND",26,24,2,"2000"
"398","2000_12_JAX_PIT",2000-11-19,"PIT","JAX",24,34,-10,"2000"
"399","2000_12_NYJ_MIA",2000-11-19,"MIA","NYJ",3,20,-17,"2000"
"400","2000_12_OAK_NO",2000-11-19,"NO","LV",22,31,-9,"2000"
"401","2000_12_SD_DEN",2000-11-19,"DEN","LAC",38,37,1,"2000"
"402","2000_12_TB_CHI",2000-11-19,"CHI","TB",13,10,3,"2000"
"403","2000_12_WAS_STL",2000-11-20,"LA","WAS",20,33,-13,"2000"
"404","2000_13_ATL_OAK",2000-11-26,"LV","ATL",41,14,27,"2000"
"405","2000_13_BUF_TB",2000-11-26,"TB","BUF",31,17,14,"2000"
"406","2000_13_CHI_NYJ",2000-11-26,"NYJ","CHI",17,10,7,"2000"
"407","2000_13_CLE_BAL",2000-11-26,"BAL","CLE",44,7,37,"2000"
"408","2000_13_DEN_SEA",2000-11-26,"SEA","DEN",31,38,-7,"2000"
"409","2000_13_GB_CAR",2000-11-27,"CAR","GB",31,14,17,"2000"
"410","2000_13_KC_SD",2000-11-26,"LAC","KC",17,16,1,"2000"
"411","2000_13_MIA_IND",2000-11-26,"IND","MIA",14,17,-3,"2000"
"412","2000_13_MIN_DAL",2000-11-23,"DAL","MIN",15,27,-12,"2000"
"413","2000_13_NE_DET",2000-11-23,"DET","NE",34,9,25,"2000"
"414","2000_13_NO_STL",2000-11-26,"LA","NO",24,31,-7,"2000"
"415","2000_13_NYG_ARI",2000-11-26,"ARI","NYG",7,31,-24,"2000"
"416","2000_13_PHI_WAS",2000-11-26,"WAS","PHI",20,23,-3,"2000"
"417","2000_13_PIT_CIN",2000-11-26,"CIN","PIT",28,48,-20,"2000"
"418","2000_13_TEN_JAX",2000-11-26,"JAX","TEN",16,13,3,"2000"
"419","2000_14_ARI_CIN",2000-12-03,"CIN","ARI",24,13,11,"2000"
"420","2000_14_CLE_JAX",2000-12-03,"JAX","CLE",48,0,48,"2000"
"421","2000_14_DAL_TB",2000-12-03,"TB","DAL",27,7,20,"2000"
"422","2000_14_DEN_NO",2000-12-03,"NO","DEN",23,38,-15,"2000"
"423","2000_14_DET_MIN",2000-11-30,"MIN","DET",24,17,7,"2000"
"424","2000_14_GB_CHI",2000-12-03,"CHI","GB",6,28,-22,"2000"
"425","2000_14_IND_NYJ",2000-12-03,"NYJ","IND",27,17,10,"2000"
"426","2000_14_KC_NE",2000-12-04,"NE","KC",30,24,6,"2000"
"427","2000_14_MIA_BUF",2000-12-03,"BUF","MIA",6,33,-27,"2000"
"428","2000_14_NYG_WAS",2000-12-03,"WAS","NYG",7,9,-2,"2000"
"429","2000_14_OAK_PIT",2000-12-03,"PIT","LV",21,20,1,"2000"
"430","2000_14_SEA_ATL",2000-12-03,"ATL","SEA",10,30,-20,"2000"
"431","2000_14_SF_SD",2000-12-03,"LAC","SF",17,45,-28,"2000"
"432","2000_14_STL_CAR",2000-12-03,"CAR","LA",16,3,13,"2000"
"433","2000_14_TEN_PHI",2000-12-03,"PHI","TEN",13,15,-2,"2000"
"434","2000_15_ARI_JAX",2000-12-10,"JAX","ARI",44,10,34,"2000"
"435","2000_15_BUF_IND",2000-12-11,"IND","BUF",44,20,24,"2000"
"436","2000_15_CAR_KC",2000-12-10,"KC","CAR",15,14,1,"2000"
"437","2000_15_CIN_TEN",2000-12-10,"TEN","CIN",35,3,32,"2000"
"438","2000_15_DET_GB",2000-12-10,"GB","DET",26,13,13,"2000"
"439","2000_15_MIN_STL",2000-12-10,"LA","MIN",40,29,11,"2000"
"440","2000_15_NE_CHI",2000-12-10,"CHI","NE",24,17,7,"2000"
"441","2000_15_NO_SF",2000-12-10,"SF","NO",27,31,-4,"2000"
"442","2000_15_NYJ_OAK",2000-12-10,"LV","NYJ",31,7,24,"2000"
"443","2000_15_PHI_CLE",2000-12-10,"CLE","PHI",24,35,-11,"2000"
"444","2000_15_PIT_NYG",2000-12-10,"NYG","PIT",30,10,20,"2000"
"445","2000_15_SD_BAL",2000-12-10,"BAL","LAC",24,3,21,"2000"
"446","2000_15_SEA_DEN",2000-12-10,"DEN","SEA",31,24,7,"2000"
"447","2000_15_TB_MIA",2000-12-10,"MIA","TB",13,16,-3,"2000"
"448","2000_15_WAS_DAL",2000-12-10,"DAL","WAS",32,13,19,"2000"
"449","2000_16_ATL_NO",2000-12-17,"NO","ATL",23,7,16,"2000"
"450","2000_16_BAL_ARI",2000-12-17,"ARI","BAL",7,13,-6,"2000"
"451","2000_16_CHI_SF",2000-12-17,"SF","CHI",17,0,17,"2000"
"452","2000_16_DEN_KC",2000-12-17,"KC","DEN",20,7,13,"2000"
"453","2000_16_DET_NYJ",2000-12-17,"NYJ","DET",7,10,-3,"2000"
"454","2000_16_GB_MIN",2000-12-17,"MIN","GB",28,33,-5,"2000"
"455","2000_16_IND_MIA",2000-12-17,"MIA","IND",13,20,-7,"2000"
"456","2000_16_JAX_CIN",2000-12-17,"CIN","JAX",17,14,3,"2000"
"457","2000_16_NE_BUF",2000-12-17,"BUF","NE",10,13,-3,"2000"
"458","2000_16_NYG_DAL",2000-12-17,"DAL","NYG",13,17,-4,"2000"
"459","2000_16_OAK_SEA",2000-12-16,"SEA","LV",27,24,3,"2000"
"460","2000_16_SD_CAR",2000-12-17,"CAR","LAC",30,22,8,"2000"
"461","2000_16_STL_TB",2000-12-18,"TB","LA",38,35,3,"2000"
"462","2000_16_TEN_CLE",2000-12-17,"CLE","TEN",0,24,-24,"2000"
"463","2000_16_WAS_PIT",2000-12-16,"PIT","WAS",24,3,21,"2000"
"464","2000_17_ARI_WAS",2000-12-24,"WAS","ARI",20,3,17,"2000"
"465","2000_17_BUF_SEA",2000-12-23,"SEA","BUF",23,42,-19,"2000"
"466","2000_17_CAR_OAK",2000-12-24,"LV","CAR",52,9,43,"2000"
"467","2000_17_CHI_DET",2000-12-24,"DET","CHI",20,23,-3,"2000"
"468","2000_17_CIN_PHI",2000-12-24,"PHI","CIN",16,7,9,"2000"
"469","2000_17_DAL_TEN",2000-12-25,"TEN","DAL",31,0,31,"2000"
"470","2000_17_JAX_NYG",2000-12-23,"NYG","JAX",28,25,3,"2000"
"471","2000_17_KC_ATL",2000-12-24,"ATL","KC",29,13,16,"2000"
"472","2000_17_MIA_NE",2000-12-24,"NE","MIA",24,27,-3,"2000"
"473","2000_17_MIN_IND",2000-12-24,"IND","MIN",31,10,21,"2000"
"474","2000_17_NYJ_BAL",2000-12-24,"BAL","NYJ",34,20,14,"2000"
"475","2000_17_PIT_SD",2000-12-24,"LAC","PIT",21,34,-13,"2000"
"476","2000_17_SF_DEN",2000-12-23,"DEN","SF",38,9,29,"2000"
"477","2000_17_STL_NO",2000-12-24,"NO","LA",21,26,-5,"2000"
"478","2000_17_TB_GB",2000-12-24,"GB","TB",17,14,3,"2000"
"479","2000_18_DEN_BAL",2000-12-31,"BAL","DEN",21,3,18,"2000"
"480","2000_18_IND_MIA",2000-12-30,"MIA","IND",23,17,6,"2000"
"481","2000_18_STL_NO",2000-12-30,"NO","LA",31,28,3,"2000"
"482","2000_18_TB_PHI",2000-12-31,"PHI","TB",21,3,18,"2000"
"483","2001_01_ATL_SF",2001-09-09,"SF","ATL",16,13,3,"2001"
"484","2001_01_CAR_MIN",2001-09-09,"MIN","CAR",13,24,-11,"2001"
"485","2001_01_CHI_BAL",2001-09-09,"BAL","CHI",17,6,11,"2001"
"486","2001_01_DET_GB",2001-09-09,"GB","DET",28,6,22,"2001"
"487","2001_01_IND_NYJ",2001-09-09,"NYJ","IND",24,45,-21,"2001"
"488","2001_01_MIA_TEN",2001-09-09,"TEN","MIA",23,31,-8,"2001"
"489","2001_01_NE_CIN",2001-09-09,"CIN","NE",23,17,6,"2001"
"490","2001_01_NO_BUF",2001-09-09,"BUF","NO",6,24,-18,"2001"
"491","2001_01_NYG_DEN",2001-09-10,"DEN","NYG",31,20,11,"2001"
"492","2001_01_OAK_KC",2001-09-09,"KC","LV",24,27,-3,"2001"
"493","2001_01_PIT_JAX",2001-09-09,"JAX","PIT",3,21,-18,"2001"
"494","2001_01_SEA_CLE",2001-09-09,"CLE","SEA",6,9,-3,"2001"
"495","2001_01_STL_PHI",2001-09-09,"PHI","LA",17,20,-3,"2001"
"496","2001_01_TB_DAL",2001-09-09,"DAL","TB",6,10,-4,"2001"
"497","2001_01_WAS_SD",2001-09-09,"LAC","WAS",30,3,27,"2001"
"498","2001_02_BAL_CIN",2001-09-23,"CIN","BAL",21,10,11,"2001"
"499","2001_02_BUF_IND",2001-09-23,"IND","BUF",42,26,16,"2001"
"500","2001_02_CAR_ATL",2001-09-23,"ATL","CAR",24,16,8,"2001"
"501","2001_02_DEN_ARI",2001-09-23,"ARI","DEN",17,38,-21,"2001"
"502","2001_02_DET_CLE",2001-09-23,"CLE","DET",24,14,10,"2001"
"503","2001_02_MIN_CHI",2001-09-23,"CHI","MIN",17,10,7,"2001"
"504","2001_02_NYG_KC",2001-09-23,"KC","NYG",3,13,-10,"2001"
"505","2001_02_NYJ_NE",2001-09-23,"NE","NYJ",3,10,-7,"2001"
"506","2001_02_OAK_MIA",2001-09-23,"MIA","LV",18,15,3,"2001"
"507","2001_02_PHI_SEA",2001-09-23,"SEA","PHI",3,27,-24,"2001"
"508","2001_02_SD_DAL",2001-09-23,"DAL","LAC",21,32,-11,"2001"
"509","2001_02_STL_SF",2001-09-23,"SF","LA",26,30,-4,"2001"
"510","2001_02_TEN_JAX",2001-09-23,"JAX","TEN",7,12,-5,"2001"
"511","2001_02_WAS_GB",2001-09-24,"GB","WAS",37,0,37,"2001"
"512","2001_03_ATL_ARI",2001-09-30,"ARI","ATL",14,34,-20,"2001"
"513","2001_03_BAL_DEN",2001-09-30,"DEN","BAL",13,20,-7,"2001"
"514","2001_03_CIN_SD",2001-09-30,"LAC","CIN",28,14,14,"2001"
"515","2001_03_CLE_JAX",2001-09-30,"JAX","CLE",2,35,-33,"2001"
"516","2001_03_DAL_PHI",2001-09-30,"PHI","DAL",40,18,22,"2001"
"517","2001_03_GB_CAR",2001-09-30,"CAR","GB",7,28,-21,"2001"
"518","2001_03_IND_NE",2001-09-30,"NE","IND",44,13,31,"2001"
"519","2001_03_KC_WAS",2001-09-30,"WAS","KC",13,45,-32,"2001"
"520","2001_03_MIA_STL",2001-09-30,"LA","MIA",42,10,32,"2001"
"521","2001_03_NO_NYG",2001-09-30,"NYG","NO",21,13,8,"2001"
"522","2001_03_PIT_BUF",2001-09-30,"BUF","PIT",3,20,-17,"2001"
"523","2001_03_SEA_OAK",2001-09-30,"LV","SEA",38,14,24,"2001"
"524","2001_03_SF_NYJ",2001-10-01,"NYJ","SF",17,19,-2,"2001"
"525","2001_03_TB_MIN",2001-09-30,"MIN","TB",20,16,4,"2001"
"526","2001_04_ARI_PHI",2001-10-07,"PHI","ARI",20,21,-1,"2001"
"527","2001_04_CAR_SF",2001-10-07,"SF","CAR",24,14,10,"2001"
"528","2001_04_CHI_ATL",2001-10-07,"ATL","CHI",3,31,-28,"2001"
"529","2001_04_CIN_PIT",2001-10-07,"PIT","CIN",16,7,9,"2001"
"530","2001_04_DAL_OAK",2001-10-07,"LV","DAL",28,21,7,"2001"
"531","2001_04_GB_TB",2001-10-07,"TB","GB",14,10,4,"2001"
"532","2001_04_JAX_SEA",2001-10-07,"SEA","JAX",24,15,9,"2001"
"533","2001_04_KC_DEN",2001-10-07,"DEN","KC",20,6,14,"2001"
"534","2001_04_MIN_NO",2001-10-07,"NO","MIN",28,15,13,"2001"
"535","2001_04_NE_MIA",2001-10-07,"MIA","NE",30,10,20,"2001"
"536","2001_04_NYJ_BUF",2001-10-07,"BUF","NYJ",36,42,-6,"2001"
"537","2001_04_SD_CLE",2001-10-07,"CLE","LAC",20,16,4,"2001"
"538","2001_04_STL_DET",2001-10-08,"DET","LA",0,35,-35,"2001"
"539","2001_04_TEN_BAL",2001-10-07,"BAL","TEN",26,7,19,"2001"
"540","2001_04_WAS_NYG",2001-10-07,"NYG","WAS",23,9,14,"2001"
"541","2001_05_ARI_CHI",2001-10-14,"CHI","ARI",20,13,7,"2001"
"542","2001_05_BAL_GB",2001-10-14,"GB","BAL",31,23,8,"2001"
"543","2001_05_CLE_CIN",2001-10-14,"CIN","CLE",24,14,10,"2001"
"544","2001_05_DEN_SEA",2001-10-14,"SEA","DEN",34,21,13,"2001"
"545","2001_05_DET_MIN",2001-10-14,"MIN","DET",31,26,5,"2001"
"546","2001_05_MIA_NYJ",2001-10-14,"NYJ","MIA",21,17,4,"2001"
"547","2001_05_NO_CAR",2001-10-14,"CAR","NO",25,27,-2,"2001"
"548","2001_05_NYG_STL",2001-10-14,"LA","NYG",15,14,1,"2001"
"549","2001_05_OAK_IND",2001-10-14,"IND","LV",18,23,-5,"2001"
"550","2001_05_PIT_KC",2001-10-14,"KC","PIT",17,20,-3,"2001"
"551","2001_05_SD_NE",2001-10-14,"NE","LAC",29,26,3,"2001"
"552","2001_05_SF_ATL",2001-10-14,"ATL","SF",31,37,-6,"2001"
"553","2001_05_TB_TEN",2001-10-14,"TEN","TB",31,28,3,"2001"
"554","2001_05_WAS_DAL",2001-10-15,"DAL","WAS",9,7,2,"2001"
"555","2001_06_ATL_NO",2001-10-21,"NO","ATL",13,20,-7,"2001"
"556","2001_06_BAL_CLE",2001-10-21,"CLE","BAL",24,14,10,"2001"
"557","2001_06_BUF_JAX",2001-10-18,"JAX","BUF",4,19,-15,"2001"
"558","2001_06_CAR_WAS",2001-10-21,"WAS","CAR",17,14,3,"2001"
"559","2001_06_CHI_CIN",2001-10-21,"CIN","CHI",0,24,-24,"2001"
"560","2001_06_DEN_SD",2001-10-21,"LAC","DEN",27,10,17,"2001"
"561","2001_06_GB_MIN",2001-10-21,"MIN","GB",35,13,22,"2001"
"562","2001_06_KC_ARI",2001-10-21,"ARI","KC",24,16,8,"2001"
"563","2001_06_NE_IND",2001-10-21,"IND","NE",17,38,-21,"2001"
"564","2001_06_PHI_NYG",2001-10-22,"NYG","PHI",9,10,-1,"2001"
"565","2001_06_PIT_TB",2001-10-21,"TB","PIT",10,17,-7,"2001"
"566","2001_06_STL_NYJ",2001-10-21,"NYJ","LA",14,34,-20,"2001"
"567","2001_06_TEN_DET",2001-10-21,"DET","TEN",24,27,-3,"2001"
"568","2001_07_ARI_DAL",2001-10-28,"DAL","ARI",17,3,14,"2001"
"569","2001_07_BUF_SD",2001-10-28,"LAC","BUF",27,24,3,"2001"
"570","2001_07_CIN_DET",2001-10-28,"DET","CIN",27,31,-4,"2001"
"571","2001_07_IND_KC",2001-10-25,"KC","IND",28,35,-7,"2001"
"572","2001_07_JAX_BAL",2001-10-28,"BAL","JAX",18,17,1,"2001"
"573","2001_07_MIA_SEA",2001-10-28,"SEA","MIA",20,24,-4,"2001"
"574","2001_07_MIN_TB",2001-10-28,"TB","MIN",41,14,27,"2001"
"575","2001_07_NE_DEN",2001-10-28,"DEN","NE",31,20,11,"2001"
"576","2001_07_NO_STL",2001-10-28,"LA","NO",31,34,-3,"2001"
"577","2001_07_NYG_WAS",2001-10-28,"WAS","NYG",35,21,14,"2001"
"578","2001_07_NYJ_CAR",2001-10-28,"CAR","NYJ",12,13,-1,"2001"
"579","2001_07_OAK_PHI",2001-10-28,"PHI","LV",10,20,-10,"2001"
"580","2001_07_SF_CHI",2001-10-28,"CHI","SF",37,31,6,"2001"
"581","2001_07_TEN_PIT",2001-10-29,"PIT","TEN",34,7,27,"2001"
"582","2001_08_BAL_PIT",2001-11-04,"PIT","BAL",10,13,-3,"2001"
"583","2001_08_CAR_MIA",2001-11-04,"MIA","CAR",23,6,17,"2001"
"584","2001_08_CLE_CHI",2001-11-04,"CHI","CLE",27,21,6,"2001"
"585","2001_08_DAL_NYG",2001-11-04,"NYG","DAL",27,24,3,"2001"
"586","2001_08_DEN_OAK",2001-11-05,"LV","DEN",38,28,10,"2001"
"587","2001_08_DET_SF",2001-11-04,"SF","DET",21,13,8,"2001"
"588","2001_08_IND_BUF",2001-11-04,"BUF","IND",14,30,-16,"2001"
"589","2001_08_JAX_TEN",2001-11-04,"TEN","JAX",28,24,4,"2001"
"590","2001_08_KC_SD",2001-11-04,"LAC","KC",20,25,-5,"2001"
"591","2001_08_NE_ATL",2001-11-04,"ATL","NE",10,24,-14,"2001"
"592","2001_08_NYJ_NO",2001-11-04,"NO","NYJ",9,16,-7,"2001"
"593","2001_08_PHI_ARI",2001-11-04,"ARI","PHI",7,21,-14,"2001"
"594","2001_08_SEA_WAS",2001-11-04,"WAS","SEA",27,14,13,"2001"
"595","2001_08_TB_GB",2001-11-04,"GB","TB",21,20,1,"2001"
"596","2001_09_BAL_TEN",2001-11-12,"TEN","BAL",10,16,-6,"2001"
"597","2001_09_BUF_NE",2001-11-11,"NE","BUF",21,11,10,"2001"
"598","2001_09_CAR_STL",2001-11-11,"LA","CAR",48,14,34,"2001"
"599","2001_09_CIN_JAX",2001-11-11,"JAX","CIN",4,39,-35,"2001"
"600","2001_09_DAL_ATL",2001-11-11,"ATL","DAL",20,13,7,"2001"
"601","2001_09_GB_CHI",2001-11-11,"CHI","GB",12,20,-8,"2001"
"602","2001_09_KC_NYJ",2001-11-11,"NYJ","KC",27,7,20,"2001"
"603","2001_09_MIA_IND",2001-11-11,"IND","MIA",24,27,-3,"2001"
"604","2001_09_MIN_PHI",2001-11-11,"PHI","MIN",48,17,31,"2001"
"605","2001_09_NO_SF",2001-11-11,"SF","NO",28,27,1,"2001"
"606","2001_09_NYG_ARI",2001-11-11,"ARI","NYG",10,17,-7,"2001"
"607","2001_09_OAK_SEA",2001-11-11,"SEA","LV",34,27,7,"2001"
"608","2001_09_PIT_CLE",2001-11-11,"CLE","PIT",12,15,-3,"2001"
"609","2001_09_SD_DEN",2001-11-11,"DEN","LAC",26,16,10,"2001"
"610","2001_09_TB_DET",2001-11-11,"DET","TB",17,20,-3,"2001"
"611","2001_10_ATL_GB",2001-11-18,"GB","ATL",20,23,-3,"2001"
"612","2001_10_CHI_TB",2001-11-18,"TB","CHI",24,27,-3,"2001"
"613","2001_10_CLE_BAL",2001-11-18,"BAL","CLE",17,27,-10,"2001"
"614","2001_10_DET_ARI",2001-11-18,"ARI","DET",45,38,7,"2001"
"615","2001_10_IND_NO",2001-11-18,"NO","IND",34,20,14,"2001"
"616","2001_10_JAX_PIT",2001-11-18,"PIT","JAX",20,7,13,"2001"
"617","2001_10_NYG_MIN",2001-11-19,"MIN","NYG",28,16,12,"2001"
"618","2001_10_NYJ_MIA",2001-11-18,"MIA","NYJ",0,24,-24,"2001"
"619","2001_10_PHI_DAL",2001-11-18,"DAL","PHI",3,36,-33,"2001"
"620","2001_10_SD_OAK",2001-11-18,"LV","LAC",34,24,10,"2001"
"621","2001_10_SEA_BUF",2001-11-18,"BUF","SEA",20,23,-3,"2001"
"622","2001_10_SF_CAR",2001-11-18,"CAR","SF",22,25,-3,"2001"
"623","2001_10_STL_NE",2001-11-18,"NE","LA",17,24,-7,"2001"
"624","2001_10_TEN_CIN",2001-11-18,"CIN","TEN",7,20,-13,"2001"
"625","2001_10_WAS_DEN",2001-11-18,"DEN","WAS",10,17,-7,"2001"
"626","2001_11_ARI_SD",2001-11-25,"LAC","ARI",17,20,-3,"2001"
"627","2001_11_ATL_CAR",2001-11-25,"CAR","ATL",7,10,-3,"2001"
"628","2001_11_BAL_JAX",2001-11-25,"JAX","BAL",3,42,-39,"2001"
"629","2001_11_CHI_MIN",2001-11-25,"MIN","CHI",6,13,-7,"2001"
"630","2001_11_CIN_CLE",2001-11-25,"CLE","CIN",18,0,18,"2001"
"631","2001_11_DEN_DAL",2001-11-22,"DAL","DEN",24,26,-2,"2001"
"632","2001_11_GB_DET",2001-11-22,"DET","GB",27,29,-2,"2001"
"633","2001_11_MIA_BUF",2001-11-25,"BUF","MIA",27,34,-7,"2001"
"634","2001_11_NO_NE",2001-11-25,"NE","NO",34,17,17,"2001"
"635","2001_11_OAK_NYG",2001-11-25,"NYG","LV",10,28,-18,"2001"
"636","2001_11_PIT_TEN",2001-11-25,"TEN","PIT",24,34,-10,"2001"
"637","2001_11_SEA_KC",2001-11-25,"KC","SEA",19,7,12,"2001"
"638","2001_11_SF_IND",2001-11-25,"IND","SF",21,40,-19,"2001"
"639","2001_11_TB_STL",2001-11-26,"LA","TB",17,24,-7,"2001"
"640","2001_11_WAS_PHI",2001-11-25,"PHI","WAS",3,13,-10,"2001"
"641","2001_12_ARI_OAK",2001-12-02,"LV","ARI",31,34,-3,"2001"
"642","2001_12_BUF_SF",2001-12-02,"SF","BUF",35,0,35,"2001"
"643","2001_12_CAR_NO",2001-12-02,"NO","CAR",27,23,4,"2001"
"644","2001_12_DAL_WAS",2001-12-02,"WAS","DAL",14,20,-6,"2001"
"645","2001_12_DEN_MIA",2001-12-02,"MIA","DEN",21,10,11,"2001"
"646","2001_12_DET_CHI",2001-12-02,"CHI","DET",13,10,3,"2001"
"647","2001_12_GB_JAX",2001-12-03,"JAX","GB",9,40,-31,"2001"
"648","2001_12_IND_BAL",2001-12-02,"BAL","IND",39,27,12,"2001"
"649","2001_12_MIN_PIT",2001-12-02,"PIT","MIN",21,16,5,"2001"
"650","2001_12_NE_NYJ",2001-12-02,"NYJ","NE",16,17,-1,"2001"
"651","2001_12_PHI_KC",2001-11-29,"KC","PHI",10,23,-13,"2001"
"652","2001_12_SD_SEA",2001-12-02,"SEA","LAC",13,10,3,"2001"
"653","2001_12_STL_ATL",2001-12-02,"ATL","LA",6,35,-29,"2001"
"654","2001_12_TB_CIN",2001-12-02,"CIN","TB",13,16,-3,"2001"
"655","2001_12_TEN_CLE",2001-12-02,"CLE","TEN",15,31,-16,"2001"
"656","2001_13_CAR_BUF",2001-12-09,"BUF","CAR",25,24,1,"2001"
"657","2001_13_CHI_GB",2001-12-09,"GB","CHI",17,7,10,"2001"
"658","2001_13_CLE_NE",2001-12-09,"NE","CLE",27,16,11,"2001"
"659","2001_13_DET_TB",2001-12-09,"TB","DET",15,12,3,"2001"
"660","2001_13_IND_MIA",2001-12-10,"MIA","IND",41,6,35,"2001"
"661","2001_13_JAX_CIN",2001-12-09,"CIN","JAX",10,14,-4,"2001"
"662","2001_13_KC_OAK",2001-12-09,"LV","KC",28,26,2,"2001"
"663","2001_13_NO_ATL",2001-12-09,"ATL","NO",10,28,-18,"2001"
"664","2001_13_NYG_DAL",2001-12-09,"DAL","NYG",20,13,7,"2001"
"665","2001_13_NYJ_PIT",2001-12-09,"PIT","NYJ",18,7,11,"2001"
"666","2001_13_SD_PHI",2001-12-09,"PHI","LAC",24,14,10,"2001"
"667","2001_13_SEA_DEN",2001-12-09,"DEN","SEA",20,7,13,"2001"
"668","2001_13_SF_STL",2001-12-09,"LA","SF",27,14,13,"2001"
"669","2001_13_TEN_MIN",2001-12-09,"MIN","TEN",42,24,18,"2001"
"670","2001_13_WAS_ARI",2001-12-09,"ARI","WAS",10,20,-10,"2001"
"671","2001_14_ARI_NYG",2001-12-15,"NYG","ARI",17,13,4,"2001"
"672","2001_14_ATL_IND",2001-12-16,"IND","ATL",41,27,14,"2001"
"673","2001_14_CIN_NYJ",2001-12-16,"NYJ","CIN",15,14,1,"2001"
"674","2001_14_DAL_SEA",2001-12-16,"SEA","DAL",29,3,26,"2001"
"675","2001_14_DEN_KC",2001-12-16,"KC","DEN",26,23,3,"2001"
"676","2001_14_GB_TEN",2001-12-16,"TEN","GB",26,20,6,"2001"
"677","2001_14_JAX_CLE",2001-12-16,"CLE","JAX",10,15,-5,"2001"
"678","2001_14_MIA_SF",2001-12-16,"SF","MIA",21,0,21,"2001"
"679","2001_14_MIN_DET",2001-12-16,"DET","MIN",27,24,3,"2001"
"680","2001_14_NE_BUF",2001-12-16,"BUF","NE",9,12,-3,"2001"
"681","2001_14_OAK_SD",2001-12-15,"LAC","LV",6,13,-7,"2001"
"682","2001_14_PHI_WAS",2001-12-16,"WAS","PHI",6,20,-14,"2001"
"683","2001_14_PIT_BAL",2001-12-16,"BAL","PIT",21,26,-5,"2001"
"684","2001_14_STL_NO",2001-12-17,"NO","LA",21,34,-13,"2001"
"685","2001_14_TB_CHI",2001-12-16,"CHI","TB",27,3,24,"2001"
"686","2001_15_BUF_ATL",2001-12-23,"ATL","BUF",33,30,3,"2001"
"687","2001_15_CHI_WAS",2001-12-23,"WAS","CHI",15,20,-5,"2001"
"688","2001_15_CIN_BAL",2001-12-23,"BAL","CIN",16,0,16,"2001"
"689","2001_15_CLE_GB",2001-12-23,"GB","CLE",30,7,23,"2001"
"690","2001_15_DAL_ARI",2001-12-23,"ARI","DAL",17,10,7,"2001"
"691","2001_15_DET_PIT",2001-12-23,"PIT","DET",47,14,33,"2001"
"692","2001_15_JAX_MIN",2001-12-23,"MIN","JAX",3,33,-30,"2001"
"693","2001_15_MIA_NE",2001-12-22,"NE","MIA",20,13,7,"2001"
"694","2001_15_NO_TB",2001-12-23,"TB","NO",48,21,27,"2001"
"695","2001_15_NYJ_IND",2001-12-23,"IND","NYJ",28,29,-1,"2001"
"696","2001_15_PHI_SF",2001-12-22,"SF","PHI",13,3,10,"2001"
"697","2001_15_SD_KC",2001-12-23,"KC","LAC",20,17,3,"2001"
"698","2001_15_SEA_NYG",2001-12-23,"NYG","SEA",27,24,3,"2001"
"699","2001_15_STL_CAR",2001-12-23,"CAR","LA",32,38,-6,"2001"
"700","2001_15_TEN_OAK",2001-12-22,"LV","TEN",10,13,-3,"2001"
"701","2001_16_ARI_CAR",2001-12-30,"CAR","ARI",7,30,-23,"2001"
"702","2001_16_ATL_MIA",2001-12-30,"MIA","ATL",21,14,7,"2001"
"703","2001_16_BAL_TB",2001-12-29,"TB","BAL",22,10,12,"2001"
"704","2001_16_BUF_NYJ",2001-12-30,"NYJ","BUF",9,14,-5,"2001"
"705","2001_16_CHI_DET",2001-12-30,"DET","CHI",0,24,-24,"2001"
"706","2001_16_CLE_TEN",2001-12-30,"TEN","CLE",38,41,-3,"2001"
"707","2001_16_IND_STL",2001-12-30,"LA","IND",42,17,25,"2001"
"708","2001_16_KC_JAX",2001-12-30,"JAX","KC",6,50,-44,"2001"
"709","2001_16_MIN_GB",2001-12-30,"GB","MIN",24,13,11,"2001"
"710","2001_16_NYG_PHI",2001-12-30,"PHI","NYG",24,21,3,"2001"
"711","2001_16_OAK_DEN",2001-12-30,"DEN","LV",23,17,6,"2001"
"712","2001_16_PIT_CIN",2001-12-30,"CIN","PIT",26,23,3,"2001"
"713","2001_16_SEA_SD",2001-12-30,"LAC","SEA",22,25,-3,"2001"
"714","2001_16_SF_DAL",2001-12-30,"DAL","SF",27,21,6,"2001"
"715","2001_16_WAS_NO",2001-12-30,"NO","WAS",10,40,-30,"2001"
"716","2002_01_ARI_WAS",2002-09-08,"WAS","ARI",31,23,8,"2002"
"717","2002_01_ATL_GB",2002-09-08,"GB","ATL",37,34,3,"2002"
"718","2002_01_BAL_CAR",2002-09-08,"CAR","BAL",10,7,3,"2002"
"719","2002_01_DAL_HOU",2002-09-08,"HOU","DAL",19,10,9,"2002"
"720","2002_01_DET_MIA",2002-09-08,"MIA","DET",49,21,28,"2002"
"721","2002_01_IND_JAX",2002-09-08,"JAX","IND",7,46,-39,"2002"
"722","2002_01_KC_CLE",2002-09-08,"CLE","KC",39,40,-1,"2002"
"723","2002_01_MIN_CHI",2002-09-08,"CHI","MIN",27,23,4,"2002"
"724","2002_01_NO_TB",2002-09-08,"TB","NO",20,26,-6,"2002"
"725","2002_01_NYJ_BUF",2002-09-08,"BUF","NYJ",31,37,-6,"2002"
"726","2002_01_PHI_TEN",2002-09-08,"TEN","PHI",27,24,3,"2002"
"727","2002_01_PIT_NE",2002-09-09,"NE","PIT",30,14,16,"2002"
"728","2002_01_SD_CIN",2002-09-08,"CIN","LAC",6,34,-28,"2002"
"729","2002_01_SEA_OAK",2002-09-08,"LV","SEA",31,17,14,"2002"
"730","2002_01_SF_NYG",2002-09-05,"NYG","SF",13,16,-3,"2002"
"731","2002_01_STL_DEN",2002-09-08,"DEN","LA",23,16,7,"2002"
"732","2002_02_ARI_SEA",2002-09-15,"SEA","ARI",13,24,-11,"2002"
"733","2002_02_BUF_MIN",2002-09-15,"MIN","BUF",39,45,-6,"2002"
"734","2002_02_CHI_ATL",2002-09-15,"ATL","CHI",13,14,-1,"2002"
"735","2002_02_CIN_CLE",2002-09-15,"CLE","CIN",20,7,13,"2002"
"736","2002_02_DEN_SF",2002-09-15,"SF","DEN",14,24,-10,"2002"
"737","2002_02_DET_CAR",2002-09-15,"CAR","DET",31,7,24,"2002"
"738","2002_02_GB_NO",2002-09-15,"NO","GB",35,20,15,"2002"
"739","2002_02_HOU_SD",2002-09-15,"LAC","HOU",24,3,21,"2002"
"740","2002_02_JAX_KC",2002-09-15,"KC","JAX",16,23,-7,"2002"
"741","2002_02_MIA_IND",2002-09-15,"IND","MIA",13,21,-8,"2002"
"742","2002_02_NE_NYJ",2002-09-15,"NYJ","NE",7,44,-37,"2002"
"743","2002_02_NYG_STL",2002-09-15,"LA","NYG",21,26,-5,"2002"
"744","2002_02_OAK_PIT",2002-09-15,"PIT","LV",17,30,-13,"2002"
"745","2002_02_PHI_WAS",2002-09-16,"WAS","PHI",7,37,-30,"2002"
"746","2002_02_TB_BAL",2002-09-15,"BAL","TB",0,25,-25,"2002"
"747","2002_02_TEN_DAL",2002-09-15,"DAL","TEN",21,13,8,"2002"
"748","2002_03_BUF_DEN",2002-09-22,"DEN","BUF",28,23,5,"2002"
"749","2002_03_CAR_MIN",2002-09-22,"MIN","CAR",14,21,-7,"2002"
"750","2002_03_CIN_ATL",2002-09-22,"ATL","CIN",30,3,27,"2002"
"751","2002_03_CLE_TEN",2002-09-22,"TEN","CLE",28,31,-3,"2002"
"752","2002_03_DAL_PHI",2002-09-22,"PHI","DAL",44,13,31,"2002"
"753","2002_03_GB_DET",2002-09-22,"DET","GB",31,37,-6,"2002"
"754","2002_03_IND_HOU",2002-09-22,"HOU","IND",3,23,-20,"2002"
"755","2002_03_KC_NE",2002-09-22,"NE","KC",41,38,3,"2002"
"756","2002_03_NO_CHI",2002-09-22,"CHI","NO",23,29,-6,"2002"
"757","2002_03_NYJ_MIA",2002-09-22,"MIA","NYJ",30,3,27,"2002"
"758","2002_03_SD_ARI",2002-09-22,"ARI","LAC",15,23,-8,"2002"
"759","2002_03_SEA_NYG",2002-09-22,"NYG","SEA",9,6,3,"2002"
"760","2002_03_STL_TB",2002-09-23,"TB","LA",26,14,12,"2002"
"761","2002_03_WAS_SF",2002-09-22,"SF","WAS",20,10,10,"2002"
"762","2002_04_CAR_GB",2002-09-29,"GB","CAR",17,14,3,"2002"
"763","2002_04_CHI_BUF",2002-09-29,"BUF","CHI",33,27,6,"2002"
"764","2002_04_CLE_PIT",2002-09-29,"PIT","CLE",16,13,3,"2002"
"765","2002_04_DAL_STL",2002-09-29,"LA","DAL",10,13,-3,"2002"
"766","2002_04_DEN_BAL",2002-09-30,"BAL","DEN",34,23,11,"2002"
"767","2002_04_HOU_PHI",2002-09-29,"PHI","HOU",35,17,18,"2002"
"768","2002_04_MIA_KC",2002-09-29,"KC","MIA",48,30,18,"2002"
"769","2002_04_MIN_SEA",2002-09-29,"SEA","MIN",48,23,25,"2002"
"770","2002_04_NE_SD",2002-09-29,"LAC","NE",21,14,7,"2002"
"771","2002_04_NO_DET",2002-09-29,"DET","NO",26,21,5,"2002"
"772","2002_04_NYG_ARI",2002-09-29,"ARI","NYG",21,7,14,"2002"
"773","2002_04_NYJ_JAX",2002-09-29,"JAX","NYJ",4,27,-23,"2002"
"774","2002_04_TB_CIN",2002-09-29,"CIN","TB",7,35,-28,"2002"
"775","2002_04_TEN_OAK",2002-09-29,"LV","TEN",52,25,27,"2002"
"776","2002_05_ARI_CAR",2002-10-06,"CAR","ARI",13,16,-3,"2002"
"777","2002_05_BAL_CLE",2002-10-06,"CLE","BAL",21,26,-5,"2002"
"778","2002_05_CIN_IND",2002-10-06,"IND","CIN",28,21,7,"2002"
"779","2002_05_GB_CHI",2002-10-07,"CHI","GB",21,34,-13,"2002"
"780","2002_05_KC_NYJ",2002-10-06,"NYJ","KC",25,29,-4,"2002"
"781","2002_05_NE_MIA",2002-10-06,"MIA","NE",26,13,13,"2002"
"782","2002_05_NYG_DAL",2002-10-06,"DAL","NYG",17,21,-4,"2002"
"783","2002_05_OAK_BUF",2002-10-06,"BUF","LV",31,49,-18,"2002"
"784","2002_05_PHI_JAX",2002-10-06,"JAX","PHI",10,43,-33,"2002"
"785","2002_05_PIT_NO",2002-10-06,"NO","PIT",32,29,3,"2002"
"786","2002_05_SD_DEN",2002-10-06,"DEN","LAC",26,9,17,"2002"
"787","2002_05_STL_SF",2002-10-06,"SF","LA",37,13,24,"2002"
"788","2002_05_TB_ATL",2002-10-06,"ATL","TB",6,20,-14,"2002"
"789","2002_05_WAS_TEN",2002-10-06,"TEN","WAS",14,31,-17,"2002"
"790","2002_06_ATL_NYG",2002-10-13,"NYG","ATL",10,17,-7,"2002"
"791","2002_06_BAL_IND",2002-10-13,"IND","BAL",22,20,2,"2002"
"792","2002_06_BUF_HOU",2002-10-13,"HOU","BUF",24,31,-7,"2002"
"793","2002_06_CAR_DAL",2002-10-13,"DAL","CAR",14,13,1,"2002"
"794","2002_06_CLE_TB",2002-10-13,"TB","CLE",17,3,14,"2002"
"795","2002_06_DET_MIN",2002-10-13,"MIN","DET",31,24,7,"2002"
"796","2002_06_GB_NE",2002-10-13,"NE","GB",10,28,-18,"2002"
"797","2002_06_JAX_TEN",2002-10-13,"TEN","JAX",23,14,9,"2002"
"798","2002_06_KC_SD",2002-10-13,"LAC","KC",35,34,1,"2002"
"799","2002_06_MIA_DEN",2002-10-13,"DEN","MIA",22,24,-2,"2002"
"800","2002_06_NO_WAS",2002-10-13,"WAS","NO",27,43,-16,"2002"
"801","2002_06_OAK_STL",2002-10-13,"LA","LV",28,13,15,"2002"
"802","2002_06_PIT_CIN",2002-10-13,"CIN","PIT",7,34,-27,"2002"
"803","2002_06_SF_SEA",2002-10-14,"SEA","SF",21,28,-7,"2002"
"804","2002_07_BUF_MIA",2002-10-20,"MIA","BUF",10,23,-13,"2002"
"805","2002_07_CAR_ATL",2002-10-20,"ATL","CAR",30,0,30,"2002"
"806","2002_07_CHI_DET",2002-10-20,"DET","CHI",23,20,3,"2002"
"807","2002_07_DAL_ARI",2002-10-20,"ARI","DAL",9,6,3,"2002"
"808","2002_07_DEN_KC",2002-10-20,"KC","DEN",34,37,-3,"2002"
"809","2002_07_HOU_CLE",2002-10-20,"CLE","HOU",34,17,17,"2002"
"810","2002_07_IND_PIT",2002-10-21,"PIT","IND",28,10,18,"2002"
"811","2002_07_JAX_BAL",2002-10-20,"BAL","JAX",17,10,7,"2002"
"812","2002_07_MIN_NYJ",2002-10-20,"NYJ","MIN",20,7,13,"2002"
"813","2002_07_SD_OAK",2002-10-20,"LV","LAC",21,27,-6,"2002"
"814","2002_07_SEA_STL",2002-10-20,"LA","SEA",37,20,17,"2002"
"815","2002_07_SF_NO",2002-10-20,"NO","SF",35,27,8,"2002"
"816","2002_07_TB_PHI",2002-10-20,"PHI","TB",20,10,10,"2002"
"817","2002_07_WAS_GB",2002-10-20,"GB","WAS",30,9,21,"2002"
"818","2002_08_ARI_SF",2002-10-27,"SF","ARI",38,28,10,"2002"
"819","2002_08_ATL_NO",2002-10-27,"NO","ATL",35,37,-2,"2002"
"820","2002_08_CHI_MIN",2002-10-27,"MIN","CHI",25,7,18,"2002"
"821","2002_08_CLE_NYJ",2002-10-27,"NYJ","CLE",21,24,-3,"2002"
"822","2002_08_DEN_NE",2002-10-27,"NE","DEN",16,24,-8,"2002"
"823","2002_08_DET_BUF",2002-10-27,"BUF","DET",24,17,7,"2002"
"824","2002_08_HOU_JAX",2002-10-27,"JAX","HOU",5,35,-30,"2002"
"825","2002_08_IND_WAS",2002-10-27,"WAS","IND",26,21,5,"2002"
"826","2002_08_NYG_PHI",2002-10-28,"PHI","NYG",17,3,14,"2002"
"827","2002_08_OAK_KC",2002-10-27,"KC","LV",20,10,10,"2002"
"828","2002_08_PIT_BAL",2002-10-27,"BAL","PIT",18,31,-13,"2002"
"829","2002_08_SEA_DAL",2002-10-27,"DAL","SEA",14,17,-3,"2002"
"830","2002_08_TB_CAR",2002-10-27,"CAR","TB",9,12,-3,"2002"
"831","2002_08_TEN_CIN",2002-10-27,"CIN","TEN",24,30,-6,"2002"
"832","2002_09_BAL_ATL",2002-11-03,"ATL","BAL",20,17,3,"2002"
"833","2002_09_CIN_HOU",2002-11-03,"HOU","CIN",3,38,-35,"2002"
"834","2002_09_DAL_DET",2002-11-03,"DET","DAL",9,7,2,"2002"
"835","2002_09_JAX_NYG",2002-11-03,"NYG","JAX",24,17,7,"2002"
"836","2002_09_MIA_GB",2002-11-04,"GB","MIA",24,10,14,"2002"
"837","2002_09_MIN_TB",2002-11-03,"TB","MIN",38,24,14,"2002"
"838","2002_09_NE_BUF",2002-11-03,"BUF","NE",7,38,-31,"2002"
"839","2002_09_NYJ_SD",2002-11-03,"LAC","NYJ",13,44,-31,"2002"
"840","2002_09_PHI_CHI",2002-11-03,"CHI","PHI",13,19,-6,"2002"
"841","2002_09_PIT_CLE",2002-11-03,"CLE","PIT",20,23,-3,"2002"
"842","2002_09_SF_OAK",2002-11-03,"LV","SF",20,23,-3,"2002"
"843","2002_09_STL_ARI",2002-11-03,"ARI","LA",14,27,-13,"2002"
"844","2002_09_TEN_IND",2002-11-03,"IND","TEN",15,23,-8,"2002"
"845","2002_09_WAS_SEA",2002-11-03,"SEA","WAS",3,14,-11,"2002"
"846","2002_10_ATL_PIT",2002-11-10,"PIT","ATL",34,34,0,"2002"
"847","2002_10_CIN_BAL",2002-11-10,"BAL","CIN",38,27,11,"2002"
"848","2002_10_DET_GB",2002-11-10,"GB","DET",40,14,26,"2002"
"849","2002_10_HOU_TEN",2002-11-10,"TEN","HOU",17,10,7,"2002"
"850","2002_10_IND_PHI",2002-11-10,"PHI","IND",13,35,-22,"2002"
"851","2002_10_KC_SF",2002-11-10,"SF","KC",17,13,4,"2002"
"852","2002_10_MIA_NYJ",2002-11-10,"NYJ","MIA",13,10,3,"2002"
"853","2002_10_NE_CHI",2002-11-10,"CHI","NE",30,33,-3,"2002"
"854","2002_10_NO_CAR",2002-11-10,"CAR","NO",24,34,-10,"2002"
"855","2002_10_NYG_MIN",2002-11-10,"MIN","NYG",20,27,-7,"2002"
"856","2002_10_OAK_DEN",2002-11-11,"DEN","LV",10,34,-24,"2002"
"857","2002_10_SD_STL",2002-11-10,"LA","LAC",28,24,4,"2002"
"858","2002_10_SEA_ARI",2002-11-10,"ARI","SEA",6,27,-21,"2002"
"859","2002_10_WAS_JAX",2002-11-10,"JAX","WAS",14,19,-5,"2002"
"860","2002_11_ARI_PHI",2002-11-17,"PHI","ARI",38,14,24,"2002"
"861","2002_11_BAL_MIA",2002-11-17,"MIA","BAL",26,7,19,"2002"
"862","2002_11_BUF_KC",2002-11-17,"KC","BUF",17,16,1,"2002"
"863","2002_11_CAR_TB",2002-11-17,"TB","CAR",23,10,13,"2002"
"864","2002_11_CHI_STL",2002-11-18,"LA","CHI",21,16,5,"2002"
"865","2002_11_CLE_CIN",2002-11-17,"CIN","CLE",20,27,-7,"2002"
"866","2002_11_DAL_IND",2002-11-17,"IND","DAL",20,3,17,"2002"
"867","2002_11_DEN_SEA",2002-11-17,"SEA","DEN",9,31,-22,"2002"
"868","2002_11_GB_MIN",2002-11-17,"MIN","GB",31,21,10,"2002"
"869","2002_11_JAX_HOU",2002-11-17,"HOU","JAX",21,24,-3,"2002"
"870","2002_11_NE_OAK",2002-11-17,"LV","NE",27,20,7,"2002"
"871","2002_11_NO_ATL",2002-11-17,"ATL","NO",24,17,7,"2002"
"872","2002_11_NYJ_DET",2002-11-17,"DET","NYJ",14,31,-17,"2002"
"873","2002_11_PIT_TEN",2002-11-17,"TEN","PIT",31,23,8,"2002"
"874","2002_11_SF_SD",2002-11-17,"LAC","SF",20,17,3,"2002"
"875","2002_11_WAS_NYG",2002-11-17,"NYG","WAS",19,17,2,"2002"
"876","2002_12_ATL_CAR",2002-11-24,"CAR","ATL",0,41,-41,"2002"
"877","2002_12_BUF_NYJ",2002-11-24,"NYJ","BUF",31,13,18,"2002"
"878","2002_12_CIN_PIT",2002-11-24,"PIT","CIN",29,21,8,"2002"
"879","2002_12_CLE_NO",2002-11-24,"NO","CLE",15,24,-9,"2002"
"880","2002_12_DET_CHI",2002-11-24,"CHI","DET",20,17,3,"2002"
"881","2002_12_GB_TB",2002-11-24,"TB","GB",21,7,14,"2002"
"882","2002_12_IND_DEN",2002-11-24,"DEN","IND",20,23,-3,"2002"
"883","2002_12_JAX_DAL",2002-11-24,"DAL","JAX",21,19,2,"2002"
"884","2002_12_KC_SEA",2002-11-24,"SEA","KC",39,32,7,"2002"
"885","2002_12_MIN_NE",2002-11-24,"NE","MIN",24,17,7,"2002"
"886","2002_12_NYG_HOU",2002-11-24,"HOU","NYG",16,14,2,"2002"
"887","2002_12_OAK_ARI",2002-11-24,"ARI","LV",20,41,-21,"2002"
"888","2002_12_PHI_SF",2002-11-25,"SF","PHI",17,38,-21,"2002"
"889","2002_12_SD_MIA",2002-11-24,"MIA","LAC",30,3,27,"2002"
"890","2002_12_STL_WAS",2002-11-24,"WAS","LA",20,17,3,"2002"
"891","2002_12_TEN_BAL",2002-11-24,"BAL","TEN",13,12,1,"2002"
"892","2002_13_ARI_KC",2002-12-01,"KC","ARI",49,0,49,"2002"
"893","2002_13_ATL_MIN",2002-12-01,"MIN","ATL",24,30,-6,"2002"
"894","2002_13_BAL_CIN",2002-12-01,"CIN","BAL",23,27,-4,"2002"
"895","2002_13_CAR_CLE",2002-12-01,"CLE","CAR",6,13,-7,"2002"
"896","2002_13_CHI_GB",2002-12-01,"GB","CHI",30,20,10,"2002"
"897","2002_13_DEN_SD",2002-12-01,"LAC","DEN",30,27,3,"2002"
"898","2002_13_HOU_IND",2002-12-01,"IND","HOU",19,3,16,"2002"
"899","2002_13_MIA_BUF",2002-12-01,"BUF","MIA",38,21,17,"2002"
"900","2002_13_NE_DET",2002-11-28,"DET","NE",12,20,-8,"2002"
"901","2002_13_NYJ_OAK",2002-12-02,"LV","NYJ",26,20,6,"2002"
"902","2002_13_PIT_JAX",2002-12-01,"JAX","PIT",5,43,-38,"2002"
"903","2002_13_SEA_SF",2002-12-01,"SF","SEA",31,24,7,"2002"
"904","2002_13_STL_PHI",2002-12-01,"PHI","LA",10,3,7,"2002"
"905","2002_13_TB_NO",2002-12-01,"NO","TB",23,20,3,"2002"
"906","2002_13_TEN_NYG",2002-12-01,"NYG","TEN",29,32,-3,"2002"
"907","2002_13_WAS_DAL",2002-11-28,"DAL","WAS",27,20,7,"2002"
"908","2002_14_ATL_TB",2002-12-08,"TB","ATL",34,10,24,"2002"
"909","2002_14_BUF_NE",2002-12-08,"NE","BUF",27,17,10,"2002"
"910","2002_14_CHI_MIA",2002-12-09,"MIA","CHI",27,9,18,"2002"
"911","2002_14_CIN_CAR",2002-12-08,"CAR","CIN",52,31,21,"2002"
"912","2002_14_CLE_JAX",2002-12-08,"JAX","CLE",8,33,-25,"2002"
"913","2002_14_DEN_NYJ",2002-12-08,"NYJ","DEN",19,13,6,"2002"
"914","2002_14_DET_ARI",2002-12-08,"ARI","DET",23,20,3,"2002"
"915","2002_14_HOU_PIT",2002-12-08,"PIT","HOU",6,24,-18,"2002"
"916","2002_14_IND_TEN",2002-12-08,"TEN","IND",27,17,10,"2002"
"917","2002_14_MIN_GB",2002-12-08,"GB","MIN",26,22,4,"2002"
"918","2002_14_NO_BAL",2002-12-08,"BAL","NO",25,37,-12,"2002"
"919","2002_14_NYG_WAS",2002-12-08,"WAS","NYG",21,27,-6,"2002"
"920","2002_14_OAK_SD",2002-12-08,"LAC","LV",7,27,-20,"2002"
"921","2002_14_PHI_SEA",2002-12-08,"SEA","PHI",20,27,-7,"2002"
"922","2002_14_SF_DAL",2002-12-08,"DAL","SF",27,31,-4,"2002"
"923","2002_14_STL_KC",2002-12-08,"KC","LA",49,10,39,"2002"
"924","2002_15_ARI_STL",2002-12-15,"LA","ARI",30,28,2,"2002"
"925","2002_15_BAL_HOU",2002-12-15,"HOU","BAL",19,23,-4,"2002"
"926","2002_15_CAR_PIT",2002-12-15,"PIT","CAR",30,14,16,"2002"
"927","2002_15_DAL_NYG",2002-12-15,"NYG","DAL",37,7,30,"2002"
"928","2002_15_GB_SF",2002-12-15,"SF","GB",14,20,-6,"2002"
"929","2002_15_IND_CLE",2002-12-15,"CLE","IND",23,28,-5,"2002"
"930","2002_15_JAX_CIN",2002-12-15,"CIN","JAX",15,29,-14,"2002"
"931","2002_15_KC_DEN",2002-12-15,"DEN","KC",31,24,7,"2002"
"932","2002_15_MIN_NO",2002-12-15,"NO","MIN",31,32,-1,"2002"
"933","2002_15_NE_TEN",2002-12-16,"TEN","NE",24,7,17,"2002"
"934","2002_15_NYJ_CHI",2002-12-15,"CHI","NYJ",20,13,7,"2002"
"935","2002_15_OAK_MIA",2002-12-15,"MIA","LV",23,17,6,"2002"
"936","2002_15_SD_BUF",2002-12-15,"BUF","LAC",20,13,7,"2002"
"937","2002_15_SEA_ATL",2002-12-15,"ATL","SEA",24,30,-6,"2002"
"938","2002_15_TB_DET",2002-12-15,"DET","TB",20,23,-3,"2002"
"939","2002_15_WAS_PHI",2002-12-15,"PHI","WAS",34,21,13,"2002"
"940","2002_16_BUF_GB",2002-12-22,"GB","BUF",10,0,10,"2002"
"941","2002_16_CHI_CAR",2002-12-22,"CAR","CHI",24,14,10,"2002"
"942","2002_16_CLE_BAL",2002-12-22,"BAL","CLE",13,14,-1,"2002"
"943","2002_16_DEN_OAK",2002-12-22,"LV","DEN",28,16,12,"2002"
"944","2002_16_DET_ATL",2002-12-22,"ATL","DET",36,15,21,"2002"
"945","2002_16_HOU_WAS",2002-12-22,"WAS","HOU",26,10,16,"2002"
"946","2002_16_MIA_MIN",2002-12-21,"MIN","MIA",20,17,3,"2002"
"947","2002_16_NO_CIN",2002-12-22,"CIN","NO",20,13,7,"2002"
"948","2002_16_NYG_IND",2002-12-22,"IND","NYG",27,44,-17,"2002"
"949","2002_16_NYJ_NE",2002-12-22,"NE","NYJ",17,30,-13,"2002"
"950","2002_16_PHI_DAL",2002-12-21,"DAL","PHI",3,27,-24,"2002"
"951","2002_16_PIT_TB",2002-12-23,"TB","PIT",7,17,-10,"2002"
"952","2002_16_SD_KC",2002-12-22,"KC","LAC",24,22,2,"2002"
"953","2002_16_SF_ARI",2002-12-21,"ARI","SF",14,17,-3,"2002"
"954","2002_16_STL_SEA",2002-12-22,"SEA","LA",30,10,20,"2002"
"955","2002_16_TEN_JAX",2002-12-22,"JAX","TEN",4,34,-30,"2002"
"956","2002_17_ARI_DEN",2002-12-29,"DEN","ARI",37,7,30,"2002"
"957","2002_17_ATL_CLE",2002-12-29,"CLE","ATL",24,16,8,"2002"
"958","2002_17_BAL_PIT",2002-12-29,"PIT","BAL",34,31,3,"2002"
"959","2002_17_CAR_NO",2002-12-29,"NO","CAR",6,10,-4,"2002"
"960","2002_17_CIN_BUF",2002-12-29,"BUF","CIN",27,9,18,"2002"
"961","2002_17_DAL_WAS",2002-12-29,"WAS","DAL",20,14,6,"2002"
"962","2002_17_GB_NYJ",2002-12-29,"NYJ","GB",42,17,25,"2002"
"963","2002_17_JAX_IND",2002-12-29,"IND","JAX",20,13,7,"2002"
"964","2002_17_KC_OAK",2002-12-28,"LV","KC",24,0,24,"2002"
"965","2002_17_MIA_NE",2002-12-29,"NE","MIA",27,24,3,"2002"
"966","2002_17_MIN_DET",2002-12-29,"DET","MIN",36,38,-2,"2002"
"967","2002_17_PHI_NYG",2002-12-28,"NYG","PHI",10,7,3,"2002"
"968","2002_17_SEA_SD",2002-12-29,"LAC","SEA",28,31,-3,"2002"
"969","2002_17_SF_STL",2002-12-30,"LA","SF",31,20,11,"2002"
"970","2002_17_TB_CHI",2002-12-29,"CHI","TB",0,15,-15,"2002"
"971","2002_17_TEN_HOU",2002-12-29,"HOU","TEN",3,13,-10,"2002"
"972","2003_01_ARI_DET",2003-09-07,"DET","ARI",42,24,18,"2003"
"973","2003_01_ATL_DAL",2003-09-07,"DAL","ATL",13,27,-14,"2003"
"974","2003_01_BAL_PIT",2003-09-07,"PIT","BAL",34,15,19,"2003"
"975","2003_01_CHI_SF",2003-09-07,"SF","CHI",49,7,42,"2003"
"976","2003_01_DEN_CIN",2003-09-07,"CIN","DEN",10,30,-20,"2003"
"977","2003_01_HOU_MIA",2003-09-07,"MIA","HOU",20,21,-1,"2003"
"978","2003_01_IND_CLE",2003-09-07,"CLE","IND",6,9,-3,"2003"
"979","2003_01_JAX_CAR",2003-09-07,"CAR","JAX",24,23,1,"2003"
"980","2003_01_MIN_GB",2003-09-07,"GB","MIN",25,30,-5,"2003"
"981","2003_01_NE_BUF",2003-09-07,"BUF","NE",31,0,31,"2003"
"982","2003_01_NO_SEA",2003-09-07,"SEA","NO",27,10,17,"2003"
"983","2003_01_NYJ_WAS",2003-09-04,"WAS","NYJ",16,13,3,"2003"
"984","2003_01_OAK_TEN",2003-09-07,"TEN","LV",25,20,5,"2003"
"985","2003_01_SD_KC",2003-09-07,"KC","LAC",27,14,13,"2003"
"986","2003_01_STL_NYG",2003-09-07,"NYG","LA",23,13,10,"2003"
"987","2003_01_TB_PHI",2003-09-08,"PHI","TB",0,17,-17,"2003"
"988","2003_02_BUF_JAX",2003-09-14,"JAX","BUF",17,38,-21,"2003"
"989","2003_02_CAR_TB",2003-09-14,"TB","CAR",9,12,-3,"2003"
"990","2003_02_CHI_MIN",2003-09-14,"MIN","CHI",24,13,11,"2003"
"991","2003_02_CIN_OAK",2003-09-14,"LV","CIN",23,20,3,"2003"
"992","2003_02_CLE_BAL",2003-09-14,"BAL","CLE",33,13,20,"2003"
"993","2003_02_DAL_NYG",2003-09-15,"NYG","DAL",32,35,-3,"2003"
"994","2003_02_DEN_SD",2003-09-14,"LAC","DEN",13,37,-24,"2003"
"995","2003_02_DET_GB",2003-09-14,"GB","DET",31,6,25,"2003"
"996","2003_02_HOU_NO",2003-09-14,"NO","HOU",31,10,21,"2003"
"997","2003_02_MIA_NYJ",2003-09-14,"NYJ","MIA",10,21,-11,"2003"
"998","2003_02_NE_PHI",2003-09-14,"PHI","NE",10,31,-21,"2003"
"999","2003_02_PIT_KC",2003-09-14,"KC","PIT",41,20,21,"2003"
"1000","2003_02_SEA_ARI",2003-09-14,"ARI","SEA",0,38,-38,"2003"
"1001","2003_02_SF_STL",2003-09-14,"LA","SF",27,24,3,"2003"
"1002","2003_02_TEN_IND",2003-09-14,"IND","TEN",33,7,26,"2003"
"1003","2003_02_WAS_ATL",2003-09-14,"ATL","WAS",31,33,-2,"2003"
"1004","2003_03_BAL_SD",2003-09-21,"LAC","BAL",10,24,-14,"2003"
"1005","2003_03_BUF_MIA",2003-09-21,"MIA","BUF",17,7,10,"2003"
"1006","2003_03_CLE_SF",2003-09-21,"SF","CLE",12,13,-1,"2003"
"1007","2003_03_GB_ARI",2003-09-21,"ARI","GB",20,13,7,"2003"
"1008","2003_03_JAX_IND",2003-09-21,"IND","JAX",23,13,10,"2003"
"1009","2003_03_KC_HOU",2003-09-21,"HOU","KC",14,42,-28,"2003"
"1010","2003_03_MIN_DET",2003-09-21,"DET","MIN",13,23,-10,"2003"
"1011","2003_03_NO_TEN",2003-09-21,"TEN","NO",27,12,15,"2003"
"1012","2003_03_NYG_WAS",2003-09-21,"WAS","NYG",21,24,-3,"2003"
"1013","2003_03_NYJ_NE",2003-09-21,"NE","NYJ",23,16,7,"2003"
"1014","2003_03_OAK_DEN",2003-09-22,"DEN","LV",31,10,21,"2003"
"1015","2003_03_PIT_CIN",2003-09-21,"CIN","PIT",10,17,-7,"2003"
"1016","2003_03_STL_SEA",2003-09-21,"SEA","LA",24,23,1,"2003"
"1017","2003_03_TB_ATL",2003-09-21,"ATL","TB",10,31,-21,"2003"
"1018","2003_04_ARI_STL",2003-09-28,"LA","ARI",37,13,24,"2003"
"1019","2003_04_ATL_CAR",2003-09-28,"CAR","ATL",23,3,20,"2003"
"1020","2003_04_CIN_CLE",2003-09-28,"CLE","CIN",14,21,-7,"2003"
"1021","2003_04_DAL_NYJ",2003-09-28,"NYJ","DAL",6,17,-11,"2003"
"1022","2003_04_DET_DEN",2003-09-28,"DEN","DET",20,16,4,"2003"
"1023","2003_04_GB_CHI",2003-09-29,"CHI","GB",23,38,-15,"2003"
"1024","2003_04_IND_NO",2003-09-28,"NO","IND",21,55,-34,"2003"
"1025","2003_04_JAX_HOU",2003-09-28,"HOU","JAX",24,20,4,"2003"
"1026","2003_04_KC_BAL",2003-09-28,"BAL","KC",10,17,-7,"2003"
"1027","2003_04_NE_WAS",2003-09-28,"WAS","NE",20,17,3,"2003"
"1028","2003_04_PHI_BUF",2003-09-28,"BUF","PHI",13,23,-10,"2003"
"1029","2003_04_SD_OAK",2003-09-28,"LV","LAC",34,31,3,"2003"
"1030","2003_04_SF_MIN",2003-09-28,"MIN","SF",35,7,28,"2003"
"1031","2003_04_TEN_PIT",2003-09-28,"PIT","TEN",13,30,-17,"2003"
"1032","2003_05_ARI_DAL",2003-10-05,"DAL","ARI",24,7,17,"2003"
"1033","2003_05_CIN_BUF",2003-10-05,"BUF","CIN",22,16,6,"2003"
"1034","2003_05_CLE_PIT",2003-10-05,"PIT","CLE",13,33,-20,"2003"
"1035","2003_05_DEN_KC",2003-10-05,"KC","DEN",24,23,1,"2003"
"1036","2003_05_DET_SF",2003-10-05,"SF","DET",24,17,7,"2003"
"1037","2003_05_IND_TB",2003-10-06,"TB","IND",35,38,-3,"2003"
"1038","2003_05_MIA_NYG",2003-10-05,"NYG","MIA",10,23,-13,"2003"
"1039","2003_05_MIN_ATL",2003-10-05,"ATL","MIN",26,39,-13,"2003"
"1040","2003_05_NO_CAR",2003-10-05,"CAR","NO",19,13,6,"2003"
"1041","2003_05_OAK_CHI",2003-10-05,"CHI","LV",24,21,3,"2003"
"1042","2003_05_SD_JAX",2003-10-05,"JAX","LAC",27,21,6,"2003"
"1043","2003_05_SEA_GB",2003-10-05,"GB","SEA",35,13,22,"2003"
"1044","2003_05_TEN_NE",2003-10-05,"NE","TEN",38,30,8,"2003"
"1045","2003_05_WAS_PHI",2003-10-05,"PHI","WAS",27,25,2,"2003"
"1046","2003_06_ATL_STL",2003-10-13,"LA","ATL",36,0,36,"2003"
"1047","2003_06_BAL_ARI",2003-10-12,"ARI","BAL",18,26,-8,"2003"
"1048","2003_06_BUF_NYJ",2003-10-12,"NYJ","BUF",30,3,27,"2003"
"1049","2003_06_CAR_IND",2003-10-12,"IND","CAR",20,23,-3,"2003"
"1050","2003_06_CHI_NO",2003-10-12,"NO","CHI",20,13,7,"2003"
"1051","2003_06_HOU_TEN",2003-10-12,"TEN","HOU",38,17,21,"2003"
"1052","2003_06_KC_GB",2003-10-12,"GB","KC",34,40,-6,"2003"
"1053","2003_06_MIA_JAX",2003-10-12,"JAX","MIA",10,24,-14,"2003"
"1054","2003_06_NYG_NE",2003-10-12,"NE","NYG",17,6,11,"2003"
"1055","2003_06_OAK_CLE",2003-10-12,"CLE","LV",13,7,6,"2003"
"1056","2003_06_PHI_DAL",2003-10-12,"DAL","PHI",23,21,2,"2003"
"1057","2003_06_PIT_DEN",2003-10-12,"DEN","PIT",17,14,3,"2003"
"1058","2003_06_SF_SEA",2003-10-12,"SEA","SF",20,19,1,"2003"
"1059","2003_06_TB_WAS",2003-10-12,"WAS","TB",13,35,-22,"2003"
"1060","2003_07_BAL_CIN",2003-10-19,"CIN","BAL",34,26,8,"2003"
"1061","2003_07_CHI_SEA",2003-10-19,"SEA","CHI",24,17,7,"2003"
"1062","2003_07_DAL_DET",2003-10-19,"DET","DAL",7,38,-31,"2003"
"1063","2003_07_DEN_MIN",2003-10-19,"MIN","DEN",28,20,8,"2003"
"1064","2003_07_GB_STL",2003-10-19,"LA","GB",34,24,10,"2003"
"1065","2003_07_KC_OAK",2003-10-20,"LV","KC",10,17,-7,"2003"
"1066","2003_07_NE_MIA",2003-10-19,"MIA","NE",13,19,-6,"2003"
"1067","2003_07_NO_ATL",2003-10-19,"ATL","NO",17,45,-28,"2003"
"1068","2003_07_NYJ_HOU",2003-10-19,"HOU","NYJ",14,19,-5,"2003"
"1069","2003_07_PHI_NYG",2003-10-19,"NYG","PHI",10,14,-4,"2003"
"1070","2003_07_SD_CLE",2003-10-19,"CLE","LAC",20,26,-6,"2003"
"1071","2003_07_TB_SF",2003-10-19,"SF","TB",24,7,17,"2003"
"1072","2003_07_TEN_CAR",2003-10-19,"CAR","TEN",17,37,-20,"2003"
"1073","2003_07_WAS_BUF",2003-10-19,"BUF","WAS",24,7,17,"2003"
"1074","2003_08_BUF_KC",2003-10-26,"KC","BUF",38,5,33,"2003"
"1075","2003_08_CAR_NO",2003-10-26,"NO","CAR",20,23,-3,"2003"
"1076","2003_08_CLE_NE",2003-10-26,"NE","CLE",9,3,6,"2003"
"1077","2003_08_DAL_TB",2003-10-26,"TB","DAL",16,0,16,"2003"
"1078","2003_08_DEN_BAL",2003-10-26,"BAL","DEN",26,6,20,"2003"
"1079","2003_08_DET_CHI",2003-10-26,"CHI","DET",24,16,8,"2003"
"1080","2003_08_HOU_IND",2003-10-26,"IND","HOU",30,21,9,"2003"
"1081","2003_08_MIA_SD",2003-10-27,"LAC","MIA",10,26,-16,"2003"
"1082","2003_08_NYG_MIN",2003-10-26,"MIN","NYG",17,29,-12,"2003"
"1083","2003_08_NYJ_PHI",2003-10-26,"PHI","NYJ",24,17,7,"2003"
"1084","2003_08_SEA_CIN",2003-10-26,"CIN","SEA",27,24,3,"2003"
"1085","2003_08_SF_ARI",2003-10-26,"ARI","SF",16,13,3,"2003"
"1086","2003_08_STL_PIT",2003-10-26,"PIT","LA",21,33,-12,"2003"
"1087","2003_08_TEN_JAX",2003-10-26,"JAX","TEN",17,30,-13,"2003"
"1088","2003_09_CAR_HOU",2003-11-02,"HOU","CAR",14,10,4,"2003"
"1089","2003_09_CIN_ARI",2003-11-02,"ARI","CIN",17,14,3,"2003"
"1090","2003_09_GB_MIN",2003-11-02,"MIN","GB",27,30,-3,"2003"
"1091","2003_09_IND_MIA",2003-11-02,"MIA","IND",17,23,-6,"2003"
"1092","2003_09_JAX_BAL",2003-11-02,"BAL","JAX",24,17,7,"2003"
"1093","2003_09_NE_DEN",2003-11-03,"DEN","NE",26,30,-4,"2003"
"1094","2003_09_NO_TB",2003-11-02,"TB","NO",14,17,-3,"2003"
"1095","2003_09_NYG_NYJ",2003-11-02,"NYJ","NYG",28,31,-3,"2003"
"1096","2003_09_OAK_DET",2003-11-02,"DET","LV",23,13,10,"2003"
"1097","2003_09_PHI_ATL",2003-11-02,"ATL","PHI",16,23,-7,"2003"
"1098","2003_09_PIT_SEA",2003-11-02,"SEA","PIT",23,16,7,"2003"
"1099","2003_09_SD_CHI",2003-11-02,"CHI","LAC",20,7,13,"2003"
"1100","2003_09_STL_SF",2003-11-02,"SF","LA",30,10,20,"2003"
"1101","2003_09_WAS_DAL",2003-11-02,"DAL","WAS",21,14,7,"2003"
"1102","2003_10_ARI_PIT",2003-11-09,"PIT","ARI",28,15,13,"2003"
"1103","2003_10_ATL_NYG",2003-11-09,"NYG","ATL",7,27,-20,"2003"
"1104","2003_10_BAL_STL",2003-11-09,"LA","BAL",33,22,11,"2003"
"1105","2003_10_BUF_DAL",2003-11-09,"DAL","BUF",10,6,4,"2003"
"1106","2003_10_CHI_DET",2003-11-09,"DET","CHI",12,10,2,"2003"
"1107","2003_10_CLE_KC",2003-11-09,"KC","CLE",41,20,21,"2003"
"1108","2003_10_HOU_CIN",2003-11-09,"CIN","HOU",34,27,7,"2003"
"1109","2003_10_IND_JAX",2003-11-09,"JAX","IND",28,23,5,"2003"
"1110","2003_10_MIA_TEN",2003-11-09,"TEN","MIA",31,7,24,"2003"
"1111","2003_10_MIN_SD",2003-11-09,"LAC","MIN",42,28,14,"2003"
"1112","2003_10_NYJ_OAK",2003-11-09,"LV","NYJ",24,27,-3,"2003"
"1113","2003_10_PHI_GB",2003-11-10,"GB","PHI",14,17,-3,"2003"
"1114","2003_10_SEA_WAS",2003-11-09,"WAS","SEA",27,20,7,"2003"
"1115","2003_10_TB_CAR",2003-11-09,"CAR","TB",27,24,3,"2003"
"1116","2003_11_ARI_CLE",2003-11-16,"CLE","ARI",44,6,38,"2003"
"1117","2003_11_ATL_NO",2003-11-16,"NO","ATL",23,20,3,"2003"
"1118","2003_11_BAL_MIA",2003-11-16,"MIA","BAL",9,6,3,"2003"
"1119","2003_11_DAL_NE",2003-11-16,"NE","DAL",12,0,12,"2003"
"1120","2003_11_DET_SEA",2003-11-16,"SEA","DET",35,14,21,"2003"
"1121","2003_11_GB_TB",2003-11-16,"TB","GB",13,20,-7,"2003"
"1122","2003_11_HOU_BUF",2003-11-16,"BUF","HOU",10,12,-2,"2003"
"1123","2003_11_JAX_TEN",2003-11-16,"TEN","JAX",10,3,7,"2003"
"1124","2003_11_KC_CIN",2003-11-16,"CIN","KC",24,19,5,"2003"
"1125","2003_11_MIN_OAK",2003-11-16,"LV","MIN",28,18,10,"2003"
"1126","2003_11_NYG_PHI",2003-11-16,"PHI","NYG",28,10,18,"2003"
"1127","2003_11_NYJ_IND",2003-11-16,"IND","NYJ",38,31,7,"2003"
"1128","2003_11_PIT_SF",2003-11-17,"SF","PIT",30,14,16,"2003"
"1129","2003_11_SD_DEN",2003-11-16,"DEN","LAC",37,8,29,"2003"
"1130","2003_11_STL_CHI",2003-11-16,"CHI","LA",21,23,-2,"2003"
"1131","2003_11_WAS_CAR",2003-11-16,"CAR","WAS",20,17,3,"2003"
"1132","2003_12_CAR_DAL",2003-11-23,"DAL","CAR",24,20,4,"2003"
"1133","2003_12_CHI_DEN",2003-11-23,"DEN","CHI",10,19,-9,"2003"
"1134","2003_12_CIN_SD",2003-11-23,"LAC","CIN",27,34,-7,"2003"
"1135","2003_12_DET_MIN",2003-11-23,"MIN","DET",24,14,10,"2003"
"1136","2003_12_IND_BUF",2003-11-23,"BUF","IND",14,17,-3,"2003"
"1137","2003_12_JAX_NYJ",2003-11-23,"NYJ","JAX",13,10,3,"2003"
"1138","2003_12_NE_HOU",2003-11-23,"HOU","NE",20,23,-3,"2003"
"1139","2003_12_NO_PHI",2003-11-23,"PHI","NO",33,20,13,"2003"
"1140","2003_12_NYG_TB",2003-11-24,"TB","NYG",19,13,6,"2003"
"1141","2003_12_OAK_KC",2003-11-23,"KC","LV",27,24,3,"2003"
"1142","2003_12_PIT_CLE",2003-11-23,"CLE","PIT",6,13,-7,"2003"
"1143","2003_12_SEA_BAL",2003-11-23,"BAL","SEA",44,41,3,"2003"
"1144","2003_12_SF_GB",2003-11-23,"GB","SF",20,10,10,"2003"
"1145","2003_12_STL_ARI",2003-11-23,"ARI","LA",27,30,-3,"2003"
"1146","2003_12_TEN_ATL",2003-11-23,"ATL","TEN",31,38,-7,"2003"
"1147","2003_12_WAS_MIA",2003-11-23,"MIA","WAS",24,23,1,"2003"
"1148","2003_13_ARI_CHI",2003-11-30,"CHI","ARI",28,3,25,"2003"
"1149","2003_13_ATL_HOU",2003-11-30,"HOU","ATL",17,13,4,"2003"
"1150","2003_13_BUF_NYG",2003-11-30,"NYG","BUF",7,24,-17,"2003"
"1151","2003_13_CIN_PIT",2003-11-30,"PIT","CIN",20,24,-4,"2003"
"1152","2003_13_CLE_SEA",2003-11-30,"SEA","CLE",34,7,27,"2003"
"1153","2003_13_DEN_OAK",2003-11-30,"LV","DEN",8,22,-14,"2003"
"1154","2003_13_GB_DET",2003-11-27,"DET","GB",22,14,8,"2003"
"1155","2003_13_KC_SD",2003-11-30,"LAC","KC",24,28,-4,"2003"
"1156","2003_13_MIA_DAL",2003-11-27,"DAL","MIA",21,40,-19,"2003"
"1157","2003_13_MIN_STL",2003-11-30,"LA","MIN",48,17,31,"2003"
"1158","2003_13_NE_IND",2003-11-30,"IND","NE",34,38,-4,"2003"
"1159","2003_13_NO_WAS",2003-11-30,"WAS","NO",20,24,-4,"2003"
"1160","2003_13_PHI_CAR",2003-11-30,"CAR","PHI",16,25,-9,"2003"
"1161","2003_13_SF_BAL",2003-11-30,"BAL","SF",44,6,38,"2003"
"1162","2003_13_TB_JAX",2003-11-30,"JAX","TB",17,10,7,"2003"
"1163","2003_13_TEN_NYJ",2003-12-01,"NYJ","TEN",24,17,7,"2003"
"1164","2003_14_ARI_SF",2003-12-07,"SF","ARI",50,14,36,"2003"
"1165","2003_14_CAR_ATL",2003-12-07,"ATL","CAR",20,14,6,"2003"
"1166","2003_14_CHI_GB",2003-12-07,"GB","CHI",34,21,13,"2003"
"1167","2003_14_CIN_BAL",2003-12-07,"BAL","CIN",31,13,18,"2003"
"1168","2003_14_DAL_PHI",2003-12-07,"PHI","DAL",36,10,26,"2003"
"1169","2003_14_HOU_JAX",2003-12-07,"JAX","HOU",27,0,27,"2003"
"1170","2003_14_IND_TEN",2003-12-07,"TEN","IND",27,29,-2,"2003"
"1171","2003_14_KC_DEN",2003-12-07,"DEN","KC",45,27,18,"2003"
"1172","2003_14_MIA_NE",2003-12-07,"NE","MIA",12,0,12,"2003"
"1173","2003_14_NYJ_BUF",2003-12-07,"BUF","NYJ",17,6,11,"2003"
"1174","2003_14_OAK_PIT",2003-12-07,"PIT","LV",27,7,20,"2003"
"1175","2003_14_SD_DET",2003-12-07,"DET","LAC",7,14,-7,"2003"
"1176","2003_14_SEA_MIN",2003-12-07,"MIN","SEA",34,7,27,"2003"
"1177","2003_14_STL_CLE",2003-12-08,"CLE","LA",20,26,-6,"2003"
"1178","2003_14_TB_NO",2003-12-07,"NO","TB",7,14,-7,"2003"
"1179","2003_14_WAS_NYG",2003-12-07,"NYG","WAS",7,20,-13,"2003"
"1180","2003_15_ATL_IND",2003-12-14,"IND","ATL",38,7,31,"2003"
"1181","2003_15_BAL_OAK",2003-12-14,"LV","BAL",20,12,8,"2003"
"1182","2003_15_BUF_TEN",2003-12-14,"TEN","BUF",28,26,2,"2003"
"1183","2003_15_CAR_ARI",2003-12-14,"ARI","CAR",17,20,-3,"2003"
"1184","2003_15_CLE_DEN",2003-12-14,"DEN","CLE",23,20,3,"2003"
"1185","2003_15_DAL_WAS",2003-12-14,"WAS","DAL",0,27,-27,"2003"
"1186","2003_15_DET_KC",2003-12-14,"KC","DET",45,17,28,"2003"
"1187","2003_15_GB_SD",2003-12-14,"LAC","GB",21,38,-17,"2003"
"1188","2003_15_HOU_TB",2003-12-14,"TB","HOU",16,3,13,"2003"
"1189","2003_15_JAX_NE",2003-12-14,"NE","JAX",27,13,14,"2003"
"1190","2003_15_MIN_CHI",2003-12-14,"CHI","MIN",13,10,3,"2003"
"1191","2003_15_NYG_NO",2003-12-14,"NO","NYG",45,7,38,"2003"
"1192","2003_15_PHI_MIA",2003-12-15,"MIA","PHI",27,34,-7,"2003"
"1193","2003_15_PIT_NYJ",2003-12-14,"NYJ","PIT",6,0,6,"2003"
"1194","2003_15_SEA_STL",2003-12-14,"LA","SEA",27,22,5,"2003"
"1195","2003_15_SF_CIN",2003-12-14,"CIN","SF",41,38,3,"2003"
"1196","2003_16_ARI_SEA",2003-12-21,"SEA","ARI",28,10,18,"2003"
"1197","2003_16_ATL_TB",2003-12-20,"TB","ATL",28,30,-2,"2003"
"1198","2003_16_BAL_CLE",2003-12-21,"CLE","BAL",0,35,-35,"2003"
"1199","2003_16_CIN_STL",2003-12-21,"LA","CIN",27,10,17,"2003"
"1200","2003_16_DEN_IND",2003-12-21,"IND","DEN",17,31,-14,"2003"
"1201","2003_16_DET_CAR",2003-12-21,"CAR","DET",20,14,6,"2003"
"1202","2003_16_GB_OAK",2003-12-22,"LV","GB",7,41,-34,"2003"
"1203","2003_16_KC_MIN",2003-12-20,"MIN","KC",45,20,25,"2003"
"1204","2003_16_MIA_BUF",2003-12-21,"BUF","MIA",3,20,-17,"2003"
"1205","2003_16_NE_NYJ",2003-12-20,"NYJ","NE",16,21,-5,"2003"
"1206","2003_16_NO_JAX",2003-12-21,"JAX","NO",20,19,1,"2003"
"1207","2003_16_NYG_DAL",2003-12-21,"DAL","NYG",19,3,16,"2003"
"1208","2003_16_SD_PIT",2003-12-21,"PIT","LAC",40,24,16,"2003"
"1209","2003_16_SF_PHI",2003-12-21,"PHI","SF",28,31,-3,"2003"
"1210","2003_16_TEN_HOU",2003-12-21,"HOU","TEN",24,27,-3,"2003"
"1211","2003_16_WAS_CHI",2003-12-21,"CHI","WAS",27,24,3,"2003"
"1212","2003_17_BUF_NE",2003-12-27,"NE","BUF",31,0,31,"2003"
"1213","2003_17_CAR_NYG",2003-12-28,"NYG","CAR",24,37,-13,"2003"
"1214","2003_17_CHI_KC",2003-12-28,"KC","CHI",31,3,28,"2003"
"1215","2003_17_CLE_CIN",2003-12-28,"CIN","CLE",14,22,-8,"2003"
"1216","2003_17_DAL_NO",2003-12-28,"NO","DAL",13,7,6,"2003"
"1217","2003_17_DEN_GB",2003-12-28,"GB","DEN",31,3,28,"2003"
"1218","2003_17_IND_HOU",2003-12-28,"HOU","IND",17,20,-3,"2003"
"1219","2003_17_JAX_ATL",2003-12-28,"ATL","JAX",21,14,7,"2003"
"1220","2003_17_MIN_ARI",2003-12-28,"ARI","MIN",18,17,1,"2003"
"1221","2003_17_NYJ_MIA",2003-12-28,"MIA","NYJ",23,21,2,"2003"
"1222","2003_17_OAK_SD",2003-12-28,"LAC","LV",21,14,7,"2003"
"1223","2003_17_PHI_WAS",2003-12-27,"WAS","PHI",7,31,-24,"2003"
"1224","2003_17_PIT_BAL",2003-12-28,"BAL","PIT",13,10,3,"2003"
"1225","2003_17_SEA_SF",2003-12-27,"SF","SEA",17,24,-7,"2003"
"1226","2003_17_STL_DET",2003-12-28,"DET","LA",30,20,10,"2003"
"1227","2003_17_TB_TEN",2003-12-28,"TEN","TB",33,13,20,"2003"
"1228","2004_01_ARI_STL",2004-09-12,"LA","ARI",17,10,7,"2004"
"1229","2004_01_ATL_SF",2004-09-12,"SF","ATL",19,21,-2,"2004"
"1230","2004_01_BAL_CLE",2004-09-12,"CLE","BAL",20,3,17,"2004"
"1231","2004_01_CIN_NYJ",2004-09-12,"NYJ","CIN",31,24,7,"2004"
"1232","2004_01_DAL_MIN",2004-09-12,"MIN","DAL",35,17,18,"2004"
"1233","2004_01_DET_CHI",2004-09-12,"CHI","DET",16,20,-4,"2004"
"1234","2004_01_GB_CAR",2004-09-13,"CAR","GB",14,24,-10,"2004"
"1235","2004_01_IND_NE",2004-09-09,"NE","IND",27,24,3,"2004"
"1236","2004_01_JAX_BUF",2004-09-12,"BUF","JAX",10,13,-3,"2004"
"1237","2004_01_KC_DEN",2004-09-12,"DEN","KC",34,24,10,"2004"
"1238","2004_01_NYG_PHI",2004-09-12,"PHI","NYG",31,17,14,"2004"
"1239","2004_01_OAK_PIT",2004-09-12,"PIT","LV",24,21,3,"2004"
"1240","2004_01_SD_HOU",2004-09-12,"HOU","LAC",20,27,-7,"2004"
"1241","2004_01_SEA_NO",2004-09-12,"NO","SEA",7,21,-14,"2004"
"1242","2004_01_TB_WAS",2004-09-12,"WAS","TB",16,10,6,"2004"
"1243","2004_01_TEN_MIA",2004-09-11,"MIA","TEN",7,17,-10,"2004"
"1244","2004_02_BUF_OAK",2004-09-19,"LV","BUF",13,10,3,"2004"
"1245","2004_02_CAR_KC",2004-09-19,"KC","CAR",17,28,-11,"2004"
"1246","2004_02_CHI_GB",2004-09-19,"GB","CHI",10,21,-11,"2004"
"1247","2004_02_CLE_DAL",2004-09-19,"DAL","CLE",19,12,7,"2004"
"1248","2004_02_DEN_JAX",2004-09-19,"JAX","DEN",7,6,1,"2004"
"1249","2004_02_HOU_DET",2004-09-19,"DET","HOU",28,16,12,"2004"
"1250","2004_02_IND_TEN",2004-09-19,"TEN","IND",17,31,-14,"2004"
"1251","2004_02_MIA_CIN",2004-09-19,"CIN","MIA",16,13,3,"2004"
"1252","2004_02_MIN_PHI",2004-09-20,"PHI","MIN",27,16,11,"2004"
"1253","2004_02_NE_ARI",2004-09-19,"ARI","NE",12,23,-11,"2004"
"1254","2004_02_NYJ_SD",2004-09-19,"LAC","NYJ",28,34,-6,"2004"
"1255","2004_02_PIT_BAL",2004-09-19,"BAL","PIT",30,13,17,"2004"
"1256","2004_02_SEA_TB",2004-09-19,"TB","SEA",6,10,-4,"2004"
"1257","2004_02_SF_NO",2004-09-19,"NO","SF",30,27,3,"2004"
"1258","2004_02_STL_ATL",2004-09-19,"ATL","LA",34,17,17,"2004"
"1259","2004_02_WAS_NYG",2004-09-19,"NYG","WAS",20,14,6,"2004"
"1260","2004_03_ARI_ATL",2004-09-26,"ATL","ARI",6,3,3,"2004"
"1261","2004_03_BAL_CIN",2004-09-26,"CIN","BAL",9,23,-14,"2004"
"1262","2004_03_CHI_MIN",2004-09-26,"MIN","CHI",27,22,5,"2004"
"1263","2004_03_CLE_NYG",2004-09-26,"NYG","CLE",27,10,17,"2004"
"1264","2004_03_DAL_WAS",2004-09-27,"WAS","DAL",18,21,-3,"2004"
"1265","2004_03_GB_IND",2004-09-26,"IND","GB",45,31,14,"2004"
"1266","2004_03_HOU_KC",2004-09-26,"KC","HOU",21,24,-3,"2004"
"1267","2004_03_JAX_TEN",2004-09-26,"TEN","JAX",12,15,-3,"2004"
"1268","2004_03_NO_STL",2004-09-26,"LA","NO",25,28,-3,"2004"
"1269","2004_03_PHI_DET",2004-09-26,"DET","PHI",13,30,-17,"2004"
"1270","2004_03_PIT_MIA",2004-09-26,"MIA","PIT",3,13,-10,"2004"
"1271","2004_03_SD_DEN",2004-09-26,"DEN","LAC",23,13,10,"2004"
"1272","2004_03_SF_SEA",2004-09-26,"SEA","SF",34,0,34,"2004"
"1273","2004_03_TB_OAK",2004-09-26,"LV","TB",30,20,10,"2004"
"1274","2004_04_ATL_CAR",2004-10-03,"CAR","ATL",10,27,-17,"2004"
"1275","2004_04_CIN_PIT",2004-10-03,"PIT","CIN",28,17,11,"2004"
"1276","2004_04_DEN_TB",2004-10-03,"TB","DEN",13,16,-3,"2004"
"1277","2004_04_IND_JAX",2004-10-03,"JAX","IND",17,24,-7,"2004"
"1278","2004_04_KC_BAL",2004-10-04,"BAL","KC",24,27,-3,"2004"
"1279","2004_04_NE_BUF",2004-10-03,"BUF","NE",17,31,-14,"2004"
"1280","2004_04_NO_ARI",2004-10-03,"ARI","NO",34,10,24,"2004"
"1281","2004_04_NYG_GB",2004-10-03,"GB","NYG",7,14,-7,"2004"
"1282","2004_04_NYJ_MIA",2004-10-03,"MIA","NYJ",9,17,-8,"2004"
"1283","2004_04_OAK_HOU",2004-10-03,"HOU","LV",30,17,13,"2004"
"1284","2004_04_PHI_CHI",2004-10-03,"CHI","PHI",9,19,-10,"2004"
"1285","2004_04_STL_SF",2004-10-03,"SF","LA",14,24,-10,"2004"
"1286","2004_04_TEN_SD",2004-10-03,"LAC","TEN",38,17,21,"2004"
"1287","2004_04_WAS_CLE",2004-10-03,"CLE","WAS",17,13,4,"2004"
"1288","2004_05_ARI_SF",2004-10-10,"SF","ARI",31,28,3,"2004"
"1289","2004_05_BAL_WAS",2004-10-10,"WAS","BAL",10,17,-7,"2004"
"1290","2004_05_BUF_NYJ",2004-10-10,"NYJ","BUF",16,14,2,"2004"
"1291","2004_05_CAR_DEN",2004-10-10,"DEN","CAR",20,17,3,"2004"
"1292","2004_05_CLE_PIT",2004-10-10,"PIT","CLE",34,23,11,"2004"
"1293","2004_05_DET_ATL",2004-10-10,"ATL","DET",10,17,-7,"2004"
"1294","2004_05_JAX_SD",2004-10-10,"LAC","JAX",34,21,13,"2004"
"1295","2004_05_MIA_NE",2004-10-10,"NE","MIA",24,10,14,"2004"
"1296","2004_05_MIN_HOU",2004-10-10,"HOU","MIN",28,34,-6,"2004"
"1297","2004_05_NYG_DAL",2004-10-10,"DAL","NYG",10,26,-16,"2004"
"1298","2004_05_OAK_IND",2004-10-10,"IND","LV",35,14,21,"2004"
"1299","2004_05_STL_SEA",2004-10-10,"SEA","LA",27,33,-6,"2004"
"1300","2004_05_TB_NO",2004-10-10,"NO","TB",17,20,-3,"2004"
"1301","2004_05_TEN_GB",2004-10-11,"GB","TEN",27,48,-21,"2004"
"1302","2004_06_CAR_PHI",2004-10-17,"PHI","CAR",30,8,22,"2004"
"1303","2004_06_CIN_CLE",2004-10-17,"CLE","CIN",34,17,17,"2004"
"1304","2004_06_DEN_OAK",2004-10-17,"LV","DEN",3,31,-28,"2004"
"1305","2004_06_GB_DET",2004-10-17,"DET","GB",10,38,-28,"2004"
"1306","2004_06_HOU_TEN",2004-10-17,"TEN","HOU",10,20,-10,"2004"
"1307","2004_06_KC_JAX",2004-10-17,"JAX","KC",22,16,6,"2004"
"1308","2004_06_MIA_BUF",2004-10-17,"BUF","MIA",20,13,7,"2004"
"1309","2004_06_MIN_NO",2004-10-17,"NO","MIN",31,38,-7,"2004"
"1310","2004_06_PIT_DAL",2004-10-17,"DAL","PIT",20,24,-4,"2004"
"1311","2004_06_SD_ATL",2004-10-17,"ATL","LAC",21,20,1,"2004"
"1312","2004_06_SEA_NE",2004-10-17,"NE","SEA",30,20,10,"2004"
"1313","2004_06_SF_NYJ",2004-10-17,"NYJ","SF",22,14,8,"2004"
"1314","2004_06_TB_STL",2004-10-18,"LA","TB",28,21,7,"2004"
"1315","2004_06_WAS_CHI",2004-10-17,"CHI","WAS",10,13,-3,"2004"
"1316","2004_07_ATL_KC",2004-10-24,"KC","ATL",56,10,46,"2004"
"1317","2004_07_BUF_BAL",2004-10-24,"BAL","BUF",20,6,14,"2004"
"1318","2004_07_CHI_TB",2004-10-24,"TB","CHI",19,7,12,"2004"
"1319","2004_07_DAL_GB",2004-10-24,"GB","DAL",41,20,21,"2004"
"1320","2004_07_DEN_CIN",2004-10-25,"CIN","DEN",23,10,13,"2004"
"1321","2004_07_DET_NYG",2004-10-24,"NYG","DET",13,28,-15,"2004"
"1322","2004_07_JAX_IND",2004-10-24,"IND","JAX",24,27,-3,"2004"
"1323","2004_07_NO_OAK",2004-10-24,"LV","NO",26,31,-5,"2004"
"1324","2004_07_NYJ_NE",2004-10-24,"NE","NYJ",13,7,6,"2004"
"1325","2004_07_PHI_CLE",2004-10-24,"CLE","PHI",31,34,-3,"2004"
"1326","2004_07_SD_CAR",2004-10-24,"CAR","LAC",6,17,-11,"2004"
"1327","2004_07_SEA_ARI",2004-10-24,"ARI","SEA",25,17,8,"2004"
"1328","2004_07_STL_MIA",2004-10-24,"MIA","LA",31,14,17,"2004"
"1329","2004_07_TEN_MIN",2004-10-24,"MIN","TEN",20,3,17,"2004"
"1330","2004_08_ARI_BUF",2004-10-31,"BUF","ARI",38,14,24,"2004"
"1331","2004_08_ATL_DEN",2004-10-31,"DEN","ATL",28,41,-13,"2004"
"1332","2004_08_BAL_PHI",2004-10-31,"PHI","BAL",15,10,5,"2004"
"1333","2004_08_CAR_SEA",2004-10-31,"SEA","CAR",23,17,6,"2004"
"1334","2004_08_CIN_TEN",2004-10-31,"TEN","CIN",27,20,7,"2004"
"1335","2004_08_DET_DAL",2004-10-31,"DAL","DET",31,21,10,"2004"
"1336","2004_08_GB_WAS",2004-10-31,"WAS","GB",14,28,-14,"2004"
"1337","2004_08_IND_KC",2004-10-31,"KC","IND",45,35,10,"2004"
"1338","2004_08_JAX_HOU",2004-10-31,"HOU","JAX",20,6,14,"2004"
"1339","2004_08_MIA_NYJ",2004-11-01,"NYJ","MIA",41,14,27,"2004"
"1340","2004_08_NE_PIT",2004-10-31,"PIT","NE",34,20,14,"2004"
"1341","2004_08_NYG_MIN",2004-10-31,"MIN","NYG",13,34,-21,"2004"
"1342","2004_08_OAK_SD",2004-10-31,"LAC","LV",42,14,28,"2004"
"1343","2004_08_SF_CHI",2004-10-31,"CHI","SF",23,13,10,"2004"
"1344","2004_09_ARI_MIA",2004-11-07,"MIA","ARI",23,24,-1,"2004"
"1345","2004_09_CHI_NYG",2004-11-07,"NYG","CHI",21,28,-7,"2004"
"1346","2004_09_CLE_BAL",2004-11-07,"BAL","CLE",27,13,14,"2004"
"1347","2004_09_DAL_CIN",2004-11-07,"CIN","DAL",26,3,23,"2004"
"1348","2004_09_HOU_DEN",2004-11-07,"DEN","HOU",31,13,18,"2004"
"1349","2004_09_KC_TB",2004-11-07,"TB","KC",34,31,3,"2004"
"1350","2004_09_MIN_IND",2004-11-08,"IND","MIN",31,28,3,"2004"
"1351","2004_09_NE_STL",2004-11-07,"LA","NE",22,40,-18,"2004"
"1352","2004_09_NO_SD",2004-11-07,"LAC","NO",43,17,26,"2004"
"1353","2004_09_NYJ_BUF",2004-11-07,"BUF","NYJ",22,17,5,"2004"
"1354","2004_09_OAK_CAR",2004-11-07,"CAR","LV",24,27,-3,"2004"
"1355","2004_09_PHI_PIT",2004-11-07,"PIT","PHI",27,3,24,"2004"
"1356","2004_09_SEA_SF",2004-11-07,"SF","SEA",27,42,-15,"2004"
"1357","2004_09_WAS_DET",2004-11-07,"DET","WAS",10,17,-7,"2004"
"1358","2004_10_BAL_NYJ",2004-11-14,"NYJ","BAL",17,20,-3,"2004"
"1359","2004_10_BUF_NE",2004-11-14,"NE","BUF",29,6,23,"2004"
"1360","2004_10_CAR_SF",2004-11-14,"SF","CAR",27,37,-10,"2004"
"1361","2004_10_CHI_TEN",2004-11-14,"TEN","CHI",17,19,-2,"2004"
"1362","2004_10_CIN_WAS",2004-11-14,"WAS","CIN",10,17,-7,"2004"
"1363","2004_10_DET_JAX",2004-11-14,"JAX","DET",23,17,6,"2004"
"1364","2004_10_HOU_IND",2004-11-14,"IND","HOU",49,14,35,"2004"
"1365","2004_10_KC_NO",2004-11-14,"NO","KC",27,20,7,"2004"
"1366","2004_10_MIN_GB",2004-11-14,"GB","MIN",34,31,3,"2004"
"1367","2004_10_NYG_ARI",2004-11-14,"ARI","NYG",17,14,3,"2004"
"1368","2004_10_PHI_DAL",2004-11-15,"DAL","PHI",21,49,-28,"2004"
"1369","2004_10_PIT_CLE",2004-11-14,"CLE","PIT",10,24,-14,"2004"
"1370","2004_10_SEA_STL",2004-11-14,"LA","SEA",23,12,11,"2004"
"1371","2004_10_TB_ATL",2004-11-14,"ATL","TB",24,14,10,"2004"
"1372","2004_11_ARI_CAR",2004-11-21,"CAR","ARI",35,10,25,"2004"
"1373","2004_11_ATL_NYG",2004-11-21,"NYG","ATL",10,14,-4,"2004"
"1374","2004_11_DAL_BAL",2004-11-21,"BAL","DAL",30,10,20,"2004"
"1375","2004_11_DEN_NO",2004-11-21,"NO","DEN",13,34,-21,"2004"
"1376","2004_11_DET_MIN",2004-11-21,"MIN","DET",22,19,3,"2004"
"1377","2004_11_GB_HOU",2004-11-21,"HOU","GB",13,16,-3,"2004"
"1378","2004_11_IND_CHI",2004-11-21,"CHI","IND",10,41,-31,"2004"
"1379","2004_11_MIA_SEA",2004-11-21,"SEA","MIA",24,17,7,"2004"
"1380","2004_11_NE_KC",2004-11-22,"KC","NE",19,27,-8,"2004"
"1381","2004_11_NYJ_CLE",2004-11-21,"CLE","NYJ",7,10,-3,"2004"
"1382","2004_11_PIT_CIN",2004-11-21,"CIN","PIT",14,19,-5,"2004"
"1383","2004_11_SD_OAK",2004-11-21,"LV","LAC",17,23,-6,"2004"
"1384","2004_11_SF_TB",2004-11-21,"TB","SF",35,3,32,"2004"
"1385","2004_11_STL_BUF",2004-11-21,"BUF","LA",37,17,20,"2004"
"1386","2004_11_TEN_JAX",2004-11-21,"JAX","TEN",15,18,-3,"2004"
"1387","2004_11_WAS_PHI",2004-11-21,"PHI","WAS",28,6,22,"2004"
"1388","2004_12_BAL_NE",2004-11-28,"NE","BAL",24,3,21,"2004"
"1389","2004_12_BUF_SEA",2004-11-28,"SEA","BUF",9,38,-29,"2004"
"1390","2004_12_CHI_DAL",2004-11-25,"DAL","CHI",21,7,14,"2004"
"1391","2004_12_CLE_CIN",2004-11-28,"CIN","CLE",58,48,10,"2004"
"1392","2004_12_IND_DET",2004-11-25,"DET","IND",9,41,-32,"2004"
"1393","2004_12_JAX_MIN",2004-11-28,"MIN","JAX",27,16,11,"2004"
"1394","2004_12_MIA_SF",2004-11-28,"SF","MIA",17,24,-7,"2004"
"1395","2004_12_NO_ATL",2004-11-28,"ATL","NO",24,21,3,"2004"
"1396","2004_12_NYJ_ARI",2004-11-28,"ARI","NYJ",3,13,-10,"2004"
"1397","2004_12_OAK_DEN",2004-11-28,"DEN","LV",24,25,-1,"2004"
"1398","2004_12_PHI_NYG",2004-11-28,"NYG","PHI",6,27,-21,"2004"
"1399","2004_12_SD_KC",2004-11-28,"KC","LAC",31,34,-3,"2004"
"1400","2004_12_STL_GB",2004-11-29,"GB","LA",45,17,28,"2004"
"1401","2004_12_TB_CAR",2004-11-28,"CAR","TB",21,14,7,"2004"
"1402","2004_12_TEN_HOU",2004-11-28,"HOU","TEN",31,21,10,"2004"
"1403","2004_12_WAS_PIT",2004-11-28,"PIT","WAS",16,7,9,"2004"
"1404","2004_13_ARI_DET",2004-12-05,"DET","ARI",26,12,14,"2004"
"1405","2004_13_ATL_TB",2004-12-05,"TB","ATL",27,0,27,"2004"
"1406","2004_13_BUF_MIA",2004-12-05,"MIA","BUF",32,42,-10,"2004"
"1407","2004_13_CAR_NO",2004-12-05,"NO","CAR",21,32,-11,"2004"
"1408","2004_13_CIN_BAL",2004-12-05,"BAL","CIN",26,27,-1,"2004"
"1409","2004_13_DAL_SEA",2004-12-06,"SEA","DAL",39,43,-4,"2004"
"1410","2004_13_DEN_SD",2004-12-05,"LAC","DEN",20,17,3,"2004"
"1411","2004_13_GB_PHI",2004-12-05,"PHI","GB",47,17,30,"2004"
"1412","2004_13_HOU_NYJ",2004-12-05,"NYJ","HOU",29,7,22,"2004"
"1413","2004_13_KC_OAK",2004-12-05,"LV","KC",27,34,-7,"2004"
"1414","2004_13_MIN_CHI",2004-12-05,"CHI","MIN",24,14,10,"2004"
"1415","2004_13_NE_CLE",2004-12-05,"CLE","NE",15,42,-27,"2004"
"1416","2004_13_NYG_WAS",2004-12-05,"WAS","NYG",31,7,24,"2004"
"1417","2004_13_PIT_JAX",2004-12-05,"JAX","PIT",16,17,-1,"2004"
"1418","2004_13_SF_STL",2004-12-05,"LA","SF",16,6,10,"2004"
"1419","2004_13_TEN_IND",2004-12-05,"IND","TEN",51,24,27,"2004"
"1420","2004_14_CHI_JAX",2004-12-12,"JAX","CHI",22,3,19,"2004"
"1421","2004_14_CIN_NE",2004-12-12,"NE","CIN",35,28,7,"2004"
"1422","2004_14_CLE_BUF",2004-12-12,"BUF","CLE",37,7,30,"2004"
"1423","2004_14_DET_GB",2004-12-12,"GB","DET",16,13,3,"2004"
"1424","2004_14_IND_HOU",2004-12-12,"HOU","IND",14,23,-9,"2004"
"1425","2004_14_KC_TEN",2004-12-13,"TEN","KC",38,49,-11,"2004"
"1426","2004_14_MIA_DEN",2004-12-12,"DEN","MIA",20,17,3,"2004"
"1427","2004_14_NO_DAL",2004-12-12,"DAL","NO",13,27,-14,"2004"
"1428","2004_14_NYG_BAL",2004-12-12,"BAL","NYG",37,14,23,"2004"
"1429","2004_14_NYJ_PIT",2004-12-12,"PIT","NYJ",17,6,11,"2004"
"1430","2004_14_OAK_ATL",2004-12-12,"ATL","LV",35,10,25,"2004"
"1431","2004_14_PHI_WAS",2004-12-12,"WAS","PHI",14,17,-3,"2004"
"1432","2004_14_SEA_MIN",2004-12-12,"MIN","SEA",23,27,-4,"2004"
"1433","2004_14_SF_ARI",2004-12-12,"ARI","SF",28,31,-3,"2004"
"1434","2004_14_STL_CAR",2004-12-12,"CAR","LA",20,7,13,"2004"
"1435","2004_14_TB_SD",2004-12-12,"LAC","TB",31,24,7,"2004"
"1436","2004_15_BAL_IND",2004-12-19,"IND","BAL",20,10,10,"2004"
"1437","2004_15_BUF_CIN",2004-12-19,"CIN","BUF",17,33,-16,"2004"
"1438","2004_15_CAR_ATL",2004-12-18,"ATL","CAR",34,31,3,"2004"
"1439","2004_15_DAL_PHI",2004-12-19,"PHI","DAL",12,7,5,"2004"
"1440","2004_15_DEN_KC",2004-12-19,"KC","DEN",45,17,28,"2004"
"1441","2004_15_HOU_CHI",2004-12-19,"CHI","HOU",5,24,-19,"2004"
"1442","2004_15_JAX_GB",2004-12-19,"GB","JAX",25,28,-3,"2004"
"1443","2004_15_MIN_DET",2004-12-19,"DET","MIN",27,28,-1,"2004"
"1444","2004_15_NE_MIA",2004-12-20,"MIA","NE",29,28,1,"2004"
"1445","2004_15_NO_TB",2004-12-19,"TB","NO",17,21,-4,"2004"
"1446","2004_15_PIT_NYG",2004-12-18,"NYG","PIT",30,33,-3,"2004"
"1447","2004_15_SD_CLE",2004-12-19,"CLE","LAC",0,21,-21,"2004"
"1448","2004_15_SEA_NYJ",2004-12-19,"NYJ","SEA",37,14,23,"2004"
"1449","2004_15_STL_ARI",2004-12-19,"ARI","LA",31,7,24,"2004"
"1450","2004_15_TEN_OAK",2004-12-19,"LV","TEN",40,35,5,"2004"
"1451","2004_15_WAS_SF",2004-12-18,"SF","WAS",16,26,-10,"2004"
"1452","2004_16_ARI_SEA",2004-12-26,"SEA","ARI",24,21,3,"2004"
"1453","2004_16_ATL_NO",2004-12-26,"NO","ATL",26,13,13,"2004"
"1454","2004_16_BAL_PIT",2004-12-26,"PIT","BAL",20,7,13,"2004"
"1455","2004_16_BUF_SF",2004-12-26,"SF","BUF",7,41,-34,"2004"
"1456","2004_16_CAR_TB",2004-12-26,"TB","CAR",20,37,-17,"2004"
"1457","2004_16_CHI_DET",2004-12-26,"DET","CHI",19,13,6,"2004"
"1458","2004_16_CLE_MIA",2004-12-26,"MIA","CLE",10,7,3,"2004"
"1459","2004_16_DEN_TEN",2004-12-25,"TEN","DEN",16,37,-21,"2004"
"1460","2004_16_GB_MIN",2004-12-24,"MIN","GB",31,34,-3,"2004"
"1461","2004_16_HOU_JAX",2004-12-26,"JAX","HOU",0,21,-21,"2004"
"1462","2004_16_NE_NYJ",2004-12-26,"NYJ","NE",7,23,-16,"2004"
"1463","2004_16_NYG_CIN",2004-12-26,"CIN","NYG",23,22,1,"2004"
"1464","2004_16_OAK_KC",2004-12-25,"KC","LV",31,30,1,"2004"
"1465","2004_16_PHI_STL",2004-12-27,"LA","PHI",20,7,13,"2004"
"1466","2004_16_SD_IND",2004-12-26,"IND","LAC",34,31,3,"2004"
"1467","2004_16_WAS_DAL",2004-12-26,"DAL","WAS",13,10,3,"2004"
"1468","2005_01_ARI_NYG",2005-09-11,"NYG","ARI",42,19,23,"2005"
"1469","2005_01_CHI_WAS",2005-09-11,"WAS","CHI",9,7,2,"2005"
"1470","2005_01_CIN_CLE",2005-09-11,"CLE","CIN",13,27,-14,"2005"
"1471","2005_01_DAL_SD",2005-09-11,"LAC","DAL",24,28,-4,"2005"
"1472","2005_01_DEN_MIA",2005-09-11,"MIA","DEN",34,10,24,"2005"
"1473","2005_01_GB_DET",2005-09-11,"DET","GB",17,3,14,"2005"
"1474","2005_01_HOU_BUF",2005-09-11,"BUF","HOU",22,7,15,"2005"
"1475","2005_01_IND_BAL",2005-09-11,"BAL","IND",7,24,-17,"2005"
"1476","2005_01_NO_CAR",2005-09-11,"CAR","NO",20,23,-3,"2005"
"1477","2005_01_NYJ_KC",2005-09-11,"KC","NYJ",27,7,20,"2005"
"1478","2005_01_OAK_NE",2005-09-08,"NE","LV",30,20,10,"2005"
"1479","2005_01_PHI_ATL",2005-09-12,"ATL","PHI",14,10,4,"2005"
"1480","2005_01_SEA_JAX",2005-09-11,"JAX","SEA",26,14,12,"2005"
"1481","2005_01_STL_SF",2005-09-11,"SF","LA",28,25,3,"2005"
"1482","2005_01_TB_MIN",2005-09-11,"MIN","TB",13,24,-11,"2005"
"1483","2005_01_TEN_PIT",2005-09-11,"PIT","TEN",34,7,27,"2005"
"1484","2005_02_ATL_SEA",2005-09-18,"SEA","ATL",21,18,3,"2005"
"1485","2005_02_BAL_TEN",2005-09-18,"TEN","BAL",25,10,15,"2005"
"1486","2005_02_BUF_TB",2005-09-18,"TB","BUF",19,3,16,"2005"
"1487","2005_02_CLE_GB",2005-09-18,"GB","CLE",24,26,-2,"2005"
"1488","2005_02_DET_CHI",2005-09-18,"CHI","DET",38,6,32,"2005"
"1489","2005_02_JAX_IND",2005-09-18,"IND","JAX",10,3,7,"2005"
"1490","2005_02_KC_OAK",2005-09-18,"LV","KC",17,23,-6,"2005"
"1491","2005_02_MIA_NYJ",2005-09-18,"NYJ","MIA",17,7,10,"2005"
"1492","2005_02_MIN_CIN",2005-09-18,"CIN","MIN",37,8,29,"2005"
"1493","2005_02_NE_CAR",2005-09-18,"CAR","NE",27,17,10,"2005"
"1494","2005_02_NYG_NO",2005-09-19,"NO","NYG",10,27,-17,"2005"
"1495","2005_02_PIT_HOU",2005-09-18,"HOU","PIT",7,27,-20,"2005"
"1496","2005_02_SD_DEN",2005-09-18,"DEN","LAC",20,17,3,"2005"
"1497","2005_02_SF_PHI",2005-09-18,"PHI","SF",42,3,39,"2005"
"1498","2005_02_STL_ARI",2005-09-18,"ARI","LA",12,17,-5,"2005"
"1499","2005_02_WAS_DAL",2005-09-19,"DAL","WAS",13,14,-1,"2005"
"1500","2005_03_ARI_SEA",2005-09-25,"SEA","ARI",37,12,25,"2005"
"1501","2005_03_ATL_BUF",2005-09-25,"BUF","ATL",16,24,-8,"2005"
"1502","2005_03_CAR_MIA",2005-09-25,"MIA","CAR",27,24,3,"2005"
"1503","2005_03_CIN_CHI",2005-09-25,"CHI","CIN",7,24,-17,"2005"
"1504","2005_03_CLE_IND",2005-09-25,"IND","CLE",13,6,7,"2005"
"1505","2005_03_DAL_SF",2005-09-25,"SF","DAL",31,34,-3,"2005"
"1506","2005_03_JAX_NYJ",2005-09-25,"NYJ","JAX",20,26,-6,"2005"
"1507","2005_03_KC_DEN",2005-09-26,"DEN","KC",30,10,20,"2005"
"1508","2005_03_NE_PIT",2005-09-25,"PIT","NE",20,23,-3,"2005"
"1509","2005_03_NO_MIN",2005-09-25,"MIN","NO",33,16,17,"2005"
"1510","2005_03_NYG_SD",2005-09-25,"LAC","NYG",45,23,22,"2005"
"1511","2005_03_OAK_PHI",2005-09-25,"PHI","LV",23,20,3,"2005"
"1512","2005_03_TB_GB",2005-09-25,"GB","TB",16,17,-1,"2005"
"1513","2005_03_TEN_STL",2005-09-25,"LA","TEN",31,27,4,"2005"
"1514","2005_04_BUF_NO",2005-10-02,"NO","BUF",19,7,12,"2005"
"1515","2005_04_DAL_OAK",2005-10-02,"LV","DAL",19,13,6,"2005"
"1516","2005_04_DEN_JAX",2005-10-02,"JAX","DEN",7,20,-13,"2005"
"1517","2005_04_DET_TB",2005-10-02,"TB","DET",17,13,4,"2005"
"1518","2005_04_GB_CAR",2005-10-03,"CAR","GB",32,29,3,"2005"
"1519","2005_04_HOU_CIN",2005-10-02,"CIN","HOU",16,10,6,"2005"
"1520","2005_04_IND_TEN",2005-10-02,"TEN","IND",10,31,-21,"2005"
"1521","2005_04_MIN_ATL",2005-10-02,"ATL","MIN",30,10,20,"2005"
"1522","2005_04_NYJ_BAL",2005-10-02,"BAL","NYJ",13,3,10,"2005"
"1523","2005_04_PHI_KC",2005-10-02,"KC","PHI",31,37,-6,"2005"
"1524","2005_04_SD_NE",2005-10-02,"NE","LAC",17,41,-24,"2005"
"1525","2005_04_SEA_WAS",2005-10-02,"WAS","SEA",20,17,3,"2005"
"1526","2005_04_SF_ARI",2005-10-02,"ARI","SF",31,14,17,"2005"
"1527","2005_04_STL_NYG",2005-10-02,"NYG","LA",44,24,20,"2005"
"1528","2005_05_BAL_DET",2005-10-09,"DET","BAL",35,17,18,"2005"
"1529","2005_05_CAR_ARI",2005-10-09,"ARI","CAR",20,24,-4,"2005"
"1530","2005_05_CHI_CLE",2005-10-09,"CLE","CHI",20,10,10,"2005"
"1531","2005_05_CIN_JAX",2005-10-09,"JAX","CIN",23,20,3,"2005"
"1532","2005_05_IND_SF",2005-10-09,"SF","IND",3,28,-25,"2005"
"1533","2005_05_MIA_BUF",2005-10-09,"BUF","MIA",20,14,6,"2005"
"1534","2005_05_NE_ATL",2005-10-09,"ATL","NE",28,31,-3,"2005"
"1535","2005_05_NO_GB",2005-10-09,"GB","NO",52,3,49,"2005"
"1536","2005_05_PHI_DAL",2005-10-09,"DAL","PHI",33,10,23,"2005"
"1537","2005_05_PIT_SD",2005-10-10,"LAC","PIT",22,24,-2,"2005"
"1538","2005_05_SEA_STL",2005-10-09,"LA","SEA",31,37,-6,"2005"
"1539","2005_05_TB_NYJ",2005-10-09,"NYJ","TB",14,12,2,"2005"
"1540","2005_05_TEN_HOU",2005-10-09,"HOU","TEN",20,34,-14,"2005"
"1541","2005_05_WAS_DEN",2005-10-09,"DEN","WAS",21,19,2,"2005"
"1542","2005_06_ATL_NO",2005-10-16,"NO","ATL",31,34,-3,"2005"
"1543","2005_06_CAR_DET",2005-10-16,"DET","CAR",20,21,-1,"2005"
"1544","2005_06_CIN_TEN",2005-10-16,"TEN","CIN",23,31,-8,"2005"
"1545","2005_06_CLE_BAL",2005-10-16,"BAL","CLE",16,3,13,"2005"
"1546","2005_06_HOU_SEA",2005-10-16,"SEA","HOU",42,10,32,"2005"
"1547","2005_06_JAX_PIT",2005-10-16,"PIT","JAX",17,23,-6,"2005"
"1548","2005_06_MIA_TB",2005-10-16,"TB","MIA",27,13,14,"2005"
"1549","2005_06_MIN_CHI",2005-10-16,"CHI","MIN",28,3,25,"2005"
"1550","2005_06_NE_DEN",2005-10-16,"DEN","NE",28,20,8,"2005"
"1551","2005_06_NYG_DAL",2005-10-16,"DAL","NYG",16,13,3,"2005"
"1552","2005_06_NYJ_BUF",2005-10-16,"BUF","NYJ",27,17,10,"2005"
"1553","2005_06_SD_OAK",2005-10-16,"LV","LAC",14,27,-13,"2005"
"1554","2005_06_STL_IND",2005-10-17,"IND","LA",45,28,17,"2005"
"1555","2005_06_WAS_KC",2005-10-16,"KC","WAS",28,21,7,"2005"
"1556","2005_07_BAL_CHI",2005-10-23,"CHI","BAL",10,6,4,"2005"
"1557","2005_07_BUF_OAK",2005-10-23,"LV","BUF",38,17,21,"2005"
"1558","2005_07_DAL_SEA",2005-10-23,"SEA","DAL",13,10,3,"2005"
"1559","2005_07_DEN_NYG",2005-10-23,"NYG","DEN",24,23,1,"2005"
"1560","2005_07_DET_CLE",2005-10-23,"CLE","DET",10,13,-3,"2005"
"1561","2005_07_GB_MIN",2005-10-23,"MIN","GB",23,20,3,"2005"
"1562","2005_07_IND_HOU",2005-10-23,"HOU","IND",20,38,-18,"2005"
"1563","2005_07_KC_MIA",2005-10-21,"MIA","KC",20,30,-10,"2005"
"1564","2005_07_NO_STL",2005-10-23,"LA","NO",28,17,11,"2005"
"1565","2005_07_NYJ_ATL",2005-10-24,"ATL","NYJ",27,14,13,"2005"
"1566","2005_07_PIT_CIN",2005-10-23,"CIN","PIT",13,27,-14,"2005"
"1567","2005_07_SD_PHI",2005-10-23,"PHI","LAC",20,17,3,"2005"
"1568","2005_07_SF_WAS",2005-10-23,"WAS","SF",52,17,35,"2005"
"1569","2005_07_TEN_ARI",2005-10-23,"ARI","TEN",20,10,10,"2005"
"1570","2005_08_ARI_DAL",2005-10-30,"DAL","ARI",34,13,21,"2005"
"1571","2005_08_BAL_PIT",2005-10-31,"PIT","BAL",20,19,1,"2005"
"1572","2005_08_BUF_NE",2005-10-30,"NE","BUF",21,16,5,"2005"
"1573","2005_08_CHI_DET",2005-10-30,"DET","CHI",13,19,-6,"2005"
"1574","2005_08_CLE_HOU",2005-10-30,"HOU","CLE",19,16,3,"2005"
"1575","2005_08_GB_CIN",2005-10-30,"CIN","GB",21,14,7,"2005"
"1576","2005_08_JAX_STL",2005-10-30,"LA","JAX",24,21,3,"2005"
"1577","2005_08_KC_SD",2005-10-30,"LAC","KC",28,20,8,"2005"
"1578","2005_08_MIA_NO",2005-10-30,"NO","MIA",6,21,-15,"2005"
"1579","2005_08_MIN_CAR",2005-10-30,"CAR","MIN",38,13,25,"2005"
"1580","2005_08_OAK_TEN",2005-10-30,"TEN","LV",25,34,-9,"2005"
"1581","2005_08_PHI_DEN",2005-10-30,"DEN","PHI",49,21,28,"2005"
"1582","2005_08_TB_SF",2005-10-30,"SF","TB",15,10,5,"2005"
"1583","2005_08_WAS_NYG",2005-10-30,"NYG","WAS",36,0,36,"2005"
"1584","2005_09_ATL_MIA",2005-11-06,"MIA","ATL",10,17,-7,"2005"
"1585","2005_09_CAR_TB",2005-11-06,"TB","CAR",14,34,-20,"2005"
"1586","2005_09_CHI_NO",2005-11-06,"NO","CHI",17,20,-3,"2005"
"1587","2005_09_CIN_BAL",2005-11-06,"BAL","CIN",9,21,-12,"2005"
"1588","2005_09_DET_MIN",2005-11-06,"MIN","DET",27,14,13,"2005"
"1589","2005_09_HOU_JAX",2005-11-06,"JAX","HOU",21,14,7,"2005"
"1590","2005_09_IND_NE",2005-11-07,"NE","IND",21,40,-19,"2005"
"1591","2005_09_NYG_SF",2005-11-06,"SF","NYG",6,24,-18,"2005"
"1592","2005_09_OAK_KC",2005-11-06,"KC","LV",27,23,4,"2005"
"1593","2005_09_PHI_WAS",2005-11-06,"WAS","PHI",17,10,7,"2005"
"1594","2005_09_PIT_GB",2005-11-06,"GB","PIT",10,20,-10,"2005"
"1595","2005_09_SD_NYJ",2005-11-06,"NYJ","LAC",26,31,-5,"2005"
"1596","2005_09_SEA_ARI",2005-11-06,"ARI","SEA",19,33,-14,"2005"
"1597","2005_09_TEN_CLE",2005-11-06,"CLE","TEN",20,14,6,"2005"
"1598","2005_10_ARI_DET",2005-11-13,"DET","ARI",29,21,8,"2005"
"1599","2005_10_BAL_JAX",2005-11-13,"JAX","BAL",30,3,27,"2005"
"1600","2005_10_CLE_PIT",2005-11-13,"PIT","CLE",34,21,13,"2005"
"1601","2005_10_DAL_PHI",2005-11-14,"PHI","DAL",20,21,-1,"2005"
"1602","2005_10_DEN_OAK",2005-11-13,"LV","DEN",17,31,-14,"2005"
"1603","2005_10_GB_ATL",2005-11-13,"ATL","GB",25,33,-8,"2005"
"1604","2005_10_HOU_IND",2005-11-13,"IND","HOU",31,17,14,"2005"
"1605","2005_10_KC_BUF",2005-11-13,"BUF","KC",14,3,11,"2005"
"1606","2005_10_MIN_NYG",2005-11-13,"NYG","MIN",21,24,-3,"2005"
"1607","2005_10_NE_MIA",2005-11-13,"MIA","NE",16,23,-7,"2005"
"1608","2005_10_NYJ_CAR",2005-11-13,"CAR","NYJ",30,3,27,"2005"
"1609","2005_10_SF_CHI",2005-11-13,"CHI","SF",17,9,8,"2005"
"1610","2005_10_STL_SEA",2005-11-13,"SEA","LA",31,16,15,"2005"
"1611","2005_10_WAS_TB",2005-11-13,"TB","WAS",36,35,1,"2005"
"1612","2005_11_ARI_STL",2005-11-20,"LA","ARI",28,38,-10,"2005"
"1613","2005_11_BUF_SD",2005-11-20,"LAC","BUF",48,10,38,"2005"
"1614","2005_11_CAR_CHI",2005-11-20,"CHI","CAR",13,3,10,"2005"
"1615","2005_11_DET_DAL",2005-11-20,"DAL","DET",20,7,13,"2005"
"1616","2005_11_IND_CIN",2005-11-20,"CIN","IND",37,45,-8,"2005"
"1617","2005_11_JAX_TEN",2005-11-20,"TEN","JAX",28,31,-3,"2005"
"1618","2005_11_KC_HOU",2005-11-20,"HOU","KC",17,45,-28,"2005"
"1619","2005_11_MIA_CLE",2005-11-20,"CLE","MIA",22,0,22,"2005"
"1620","2005_11_MIN_GB",2005-11-21,"GB","MIN",17,20,-3,"2005"
"1621","2005_11_NO_NE",2005-11-20,"NE","NO",24,17,7,"2005"
"1622","2005_11_NYJ_DEN",2005-11-20,"DEN","NYJ",27,0,27,"2005"
"1623","2005_11_OAK_WAS",2005-11-20,"WAS","LV",13,16,-3,"2005"
"1624","2005_11_PHI_NYG",2005-11-20,"NYG","PHI",27,17,10,"2005"
"1625","2005_11_PIT_BAL",2005-11-20,"BAL","PIT",16,13,3,"2005"
"1626","2005_11_SEA_SF",2005-11-20,"SF","SEA",25,27,-2,"2005"
"1627","2005_11_TB_ATL",2005-11-20,"ATL","TB",27,30,-3,"2005"
"1628","2005_12_ATL_DET",2005-11-24,"DET","ATL",7,27,-20,"2005"
"1629","2005_12_BAL_CIN",2005-11-27,"CIN","BAL",42,29,13,"2005"
"1630","2005_12_CAR_BUF",2005-11-27,"BUF","CAR",9,13,-4,"2005"
"1631","2005_12_CHI_TB",2005-11-27,"TB","CHI",10,13,-3,"2005"
"1632","2005_12_CLE_MIN",2005-11-27,"MIN","CLE",24,12,12,"2005"
"1633","2005_12_DEN_DAL",2005-11-24,"DAL","DEN",21,24,-3,"2005"
"1634","2005_12_GB_PHI",2005-11-27,"PHI","GB",19,14,5,"2005"
"1635","2005_12_JAX_ARI",2005-11-27,"ARI","JAX",17,24,-7,"2005"
"1636","2005_12_MIA_OAK",2005-11-27,"LV","MIA",21,33,-12,"2005"
"1637","2005_12_NE_KC",2005-11-27,"KC","NE",26,16,10,"2005"
"1638","2005_12_NO_NYJ",2005-11-27,"NYJ","NO",19,21,-2,"2005"
"1639","2005_12_NYG_SEA",2005-11-27,"SEA","NYG",24,21,3,"2005"
"1640","2005_12_PIT_IND",2005-11-28,"IND","PIT",26,7,19,"2005"
"1641","2005_12_SD_WAS",2005-11-27,"WAS","LAC",17,23,-6,"2005"
"1642","2005_12_SF_TEN",2005-11-27,"TEN","SF",33,22,11,"2005"
"1643","2005_12_STL_HOU",2005-11-27,"HOU","LA",27,33,-6,"2005"
"1644","2005_13_ARI_SF",2005-12-04,"SF","ARI",10,17,-7,"2005"
"1645","2005_13_ATL_CAR",2005-12-04,"CAR","ATL",24,6,18,"2005"
"1646","2005_13_BUF_MIA",2005-12-04,"MIA","BUF",24,23,1,"2005"
"1647","2005_13_CIN_PIT",2005-12-04,"PIT","CIN",31,38,-7,"2005"
"1648","2005_13_DAL_NYG",2005-12-04,"NYG","DAL",17,10,7,"2005"
"1649","2005_13_DEN_KC",2005-12-04,"KC","DEN",31,27,4,"2005"
"1650","2005_13_GB_CHI",2005-12-04,"CHI","GB",19,7,12,"2005"
"1651","2005_13_HOU_BAL",2005-12-04,"BAL","HOU",16,15,1,"2005"
"1652","2005_13_JAX_CLE",2005-12-04,"CLE","JAX",14,20,-6,"2005"
"1653","2005_13_MIN_DET",2005-12-04,"DET","MIN",16,21,-5,"2005"
"1654","2005_13_NYJ_NE",2005-12-04,"NE","NYJ",16,3,13,"2005"
"1655","2005_13_OAK_SD",2005-12-04,"LAC","LV",34,10,24,"2005"
"1656","2005_13_SEA_PHI",2005-12-05,"PHI","SEA",0,42,-42,"2005"
"1657","2005_13_TB_NO",2005-12-04,"NO","TB",3,10,-7,"2005"
"1658","2005_13_TEN_IND",2005-12-04,"IND","TEN",35,3,32,"2005"
"1659","2005_13_WAS_STL",2005-12-04,"LA","WAS",9,24,-15,"2005"
"1660","2005_14_BAL_DEN",2005-12-11,"DEN","BAL",12,10,2,"2005"
"1661","2005_14_CHI_PIT",2005-12-11,"PIT","CHI",21,9,12,"2005"
"1662","2005_14_CLE_CIN",2005-12-11,"CIN","CLE",23,20,3,"2005"
"1663","2005_14_DET_GB",2005-12-11,"GB","DET",16,13,3,"2005"
"1664","2005_14_HOU_TEN",2005-12-11,"TEN","HOU",13,10,3,"2005"
"1665","2005_14_IND_JAX",2005-12-11,"JAX","IND",18,26,-8,"2005"
"1666","2005_14_KC_DAL",2005-12-11,"DAL","KC",31,28,3,"2005"
"1667","2005_14_MIA_SD",2005-12-11,"LAC","MIA",21,23,-2,"2005"
"1668","2005_14_NE_BUF",2005-12-11,"BUF","NE",7,35,-28,"2005"
"1669","2005_14_NO_ATL",2005-12-12,"ATL","NO",36,17,19,"2005"
"1670","2005_14_NYG_PHI",2005-12-11,"PHI","NYG",23,26,-3,"2005"
"1671","2005_14_OAK_NYJ",2005-12-11,"NYJ","LV",26,10,16,"2005"
"1672","2005_14_SF_SEA",2005-12-11,"SEA","SF",41,3,38,"2005"
"1673","2005_14_STL_MIN",2005-12-11,"MIN","LA",27,13,14,"2005"
"1674","2005_14_TB_CAR",2005-12-11,"CAR","TB",10,20,-10,"2005"
"1675","2005_14_WAS_ARI",2005-12-11,"ARI","WAS",13,17,-4,"2005"
"1676","2005_15_ARI_HOU",2005-12-18,"HOU","ARI",30,19,11,"2005"
"1677","2005_15_ATL_CHI",2005-12-18,"CHI","ATL",16,3,13,"2005"
"1678","2005_15_CAR_NO",2005-12-18,"NO","CAR",10,27,-17,"2005"
"1679","2005_15_CIN_DET",2005-12-18,"DET","CIN",17,41,-24,"2005"
"1680","2005_15_CLE_OAK",2005-12-18,"LV","CLE",7,9,-2,"2005"
"1681","2005_15_DAL_WAS",2005-12-18,"WAS","DAL",35,7,28,"2005"
"1682","2005_15_DEN_BUF",2005-12-17,"BUF","DEN",17,28,-11,"2005"
"1683","2005_15_GB_BAL",2005-12-19,"BAL","GB",48,3,45,"2005"
"1684","2005_15_KC_NYG",2005-12-17,"NYG","KC",27,17,10,"2005"
"1685","2005_15_NYJ_MIA",2005-12-18,"MIA","NYJ",24,20,4,"2005"
"1686","2005_15_PHI_STL",2005-12-18,"LA","PHI",16,17,-1,"2005"
"1687","2005_15_PIT_MIN",2005-12-18,"MIN","PIT",3,18,-15,"2005"
"1688","2005_15_SD_IND",2005-12-18,"IND","LAC",17,26,-9,"2005"
"1689","2005_15_SEA_TEN",2005-12-18,"TEN","SEA",24,28,-4,"2005"
"1690","2005_15_SF_JAX",2005-12-18,"JAX","SF",10,9,1,"2005"
"1691","2005_15_TB_NE",2005-12-17,"NE","TB",28,0,28,"2005"
"1692","2005_16_ATL_TB",2005-12-24,"TB","ATL",27,24,3,"2005"
"1693","2005_16_BUF_CIN",2005-12-24,"CIN","BUF",27,37,-10,"2005"
"1694","2005_16_CHI_GB",2005-12-25,"GB","CHI",17,24,-7,"2005"
"1695","2005_16_DAL_CAR",2005-12-24,"CAR","DAL",20,24,-4,"2005"
"1696","2005_16_DET_NO",2005-12-24,"NO","DET",12,13,-1,"2005"
"1697","2005_16_IND_SEA",2005-12-24,"SEA","IND",28,13,15,"2005"
"1698","2005_16_JAX_HOU",2005-12-24,"HOU","JAX",20,38,-18,"2005"
"1699","2005_16_MIN_BAL",2005-12-25,"BAL","MIN",30,23,7,"2005"
"1700","2005_16_NE_NYJ",2005-12-26,"NYJ","NE",21,31,-10,"2005"
"1701","2005_16_NYG_WAS",2005-12-24,"WAS","NYG",35,20,15,"2005"
"1702","2005_16_OAK_DEN",2005-12-24,"DEN","LV",22,3,19,"2005"
"1703","2005_16_PHI_ARI",2005-12-24,"ARI","PHI",27,21,6,"2005"
"1704","2005_16_PIT_CLE",2005-12-24,"CLE","PIT",0,41,-41,"2005"
"1705","2005_16_SD_KC",2005-12-24,"KC","LAC",20,7,13,"2005"
"1706","2005_16_SF_STL",2005-12-24,"LA","SF",20,24,-4,"2005"
"1707","2005_16_TEN_MIA",2005-12-24,"MIA","TEN",24,10,14,"2005"
"1708","2005_17_DEN_SD",2005-12-31,"LAC","DEN",7,23,-16,"2005"
"1709","2005_17_NYG_OAK",2005-12-31,"LV","NYG",21,30,-9,"2005"
"1710","2006_01_ATL_CAR",2006-09-10,"CAR","ATL",6,20,-14,"2006"
"1711","2006_01_BAL_TB",2006-09-10,"TB","BAL",0,27,-27,"2006"
"1712","2006_01_BUF_NE",2006-09-10,"NE","BUF",19,17,2,"2006"
"1713","2006_01_CHI_GB",2006-09-10,"GB","CHI",0,26,-26,"2006"
"1714","2006_01_CIN_KC",2006-09-10,"KC","CIN",10,23,-13,"2006"
"1715","2006_01_DAL_JAX",2006-09-10,"JAX","DAL",24,17,7,"2006"
"1716","2006_01_DEN_STL",2006-09-10,"LA","DEN",18,10,8,"2006"
"1717","2006_01_IND_NYG",2006-09-10,"NYG","IND",21,26,-5,"2006"
"1718","2006_01_MIA_PIT",2006-09-07,"PIT","MIA",28,17,11,"2006"
"1719","2006_01_MIN_WAS",2006-09-11,"WAS","MIN",16,19,-3,"2006"
"1720","2006_01_NO_CLE",2006-09-10,"CLE","NO",14,19,-5,"2006"
"1721","2006_01_NYJ_TEN",2006-09-10,"TEN","NYJ",16,23,-7,"2006"
"1722","2006_01_PHI_HOU",2006-09-10,"HOU","PHI",10,24,-14,"2006"
"1723","2006_01_SD_OAK",2006-09-11,"LV","LAC",0,27,-27,"2006"
"1724","2006_01_SEA_DET",2006-09-10,"DET","SEA",6,9,-3,"2006"
"1725","2006_01_SF_ARI",2006-09-10,"ARI","SF",34,27,7,"2006"
"1726","2006_02_ARI_SEA",2006-09-17,"SEA","ARI",21,10,11,"2006"
"1727","2006_02_BUF_MIA",2006-09-17,"MIA","BUF",6,16,-10,"2006"
"1728","2006_02_CAR_MIN",2006-09-17,"MIN","CAR",16,13,3,"2006"
"1729","2006_02_CLE_CIN",2006-09-17,"CIN","CLE",34,17,17,"2006"
"1730","2006_02_DET_CHI",2006-09-17,"CHI","DET",34,7,27,"2006"
"1731","2006_02_HOU_IND",2006-09-17,"IND","HOU",43,24,19,"2006"
"1732","2006_02_KC_DEN",2006-09-17,"DEN","KC",9,6,3,"2006"
"1733","2006_02_NE_NYJ",2006-09-17,"NYJ","NE",17,24,-7,"2006"
"1734","2006_02_NO_GB",2006-09-17,"GB","NO",27,34,-7,"2006"
"1735","2006_02_NYG_PHI",2006-09-17,"PHI","NYG",24,30,-6,"2006"
"1736","2006_02_OAK_BAL",2006-09-17,"BAL","LV",28,6,22,"2006"
"1737","2006_02_PIT_JAX",2006-09-18,"JAX","PIT",9,0,9,"2006"
"1738","2006_02_STL_SF",2006-09-17,"SF","LA",20,13,7,"2006"
"1739","2006_02_TB_ATL",2006-09-17,"ATL","TB",14,3,11,"2006"
"1740","2006_02_TEN_SD",2006-09-17,"LAC","TEN",40,7,33,"2006"
"1741","2006_02_WAS_DAL",2006-09-17,"DAL","WAS",27,10,17,"2006"
"1742","2006_03_ATL_NO",2006-09-25,"NO","ATL",23,3,20,"2006"
"1743","2006_03_BAL_CLE",2006-09-24,"CLE","BAL",14,15,-1,"2006"
"1744","2006_03_CAR_TB",2006-09-24,"TB","CAR",24,26,-2,"2006"
"1745","2006_03_CHI_MIN",2006-09-24,"MIN","CHI",16,19,-3,"2006"
"1746","2006_03_CIN_PIT",2006-09-24,"PIT","CIN",20,28,-8,"2006"
"1747","2006_03_DEN_NE",2006-09-24,"NE","DEN",7,17,-10,"2006"
"1748","2006_03_GB_DET",2006-09-24,"DET","GB",24,31,-7,"2006"
"1749","2006_03_JAX_IND",2006-09-24,"IND","JAX",21,14,7,"2006"
"1750","2006_03_NYG_SEA",2006-09-24,"SEA","NYG",42,30,12,"2006"
"1751","2006_03_NYJ_BUF",2006-09-24,"BUF","NYJ",20,28,-8,"2006"
"1752","2006_03_PHI_SF",2006-09-24,"SF","PHI",24,38,-14,"2006"
"1753","2006_03_STL_ARI",2006-09-24,"ARI","LA",14,16,-2,"2006"
"1754","2006_03_TEN_MIA",2006-09-24,"MIA","TEN",13,10,3,"2006"
"1755","2006_03_WAS_HOU",2006-09-24,"HOU","WAS",15,31,-16,"2006"
"1756","2006_04_ARI_ATL",2006-10-01,"ATL","ARI",32,10,22,"2006"
"1757","2006_04_CLE_OAK",2006-10-01,"LV","CLE",21,24,-3,"2006"
"1758","2006_04_DAL_TEN",2006-10-01,"TEN","DAL",14,45,-31,"2006"
"1759","2006_04_DET_STL",2006-10-01,"LA","DET",41,34,7,"2006"
"1760","2006_04_GB_PHI",2006-10-02,"PHI","GB",31,9,22,"2006"
"1761","2006_04_IND_NYJ",2006-10-01,"NYJ","IND",28,31,-3,"2006"
"1762","2006_04_JAX_WAS",2006-10-01,"WAS","JAX",36,30,6,"2006"
"1763","2006_04_MIA_HOU",2006-10-01,"HOU","MIA",17,15,2,"2006"
"1764","2006_04_MIN_BUF",2006-10-01,"BUF","MIN",17,12,5,"2006"
"1765","2006_04_NE_CIN",2006-10-01,"CIN","NE",13,38,-25,"2006"
"1766","2006_04_NO_CAR",2006-10-01,"CAR","NO",21,18,3,"2006"
"1767","2006_04_SD_BAL",2006-10-01,"BAL","LAC",16,13,3,"2006"
"1768","2006_04_SEA_CHI",2006-10-01,"CHI","SEA",37,6,31,"2006"
"1769","2006_04_SF_KC",2006-10-01,"KC","SF",41,0,41,"2006"
"1770","2006_05_BAL_DEN",2006-10-09,"DEN","BAL",13,3,10,"2006"
"1771","2006_05_BUF_CHI",2006-10-08,"CHI","BUF",40,7,33,"2006"
"1772","2006_05_CLE_CAR",2006-10-08,"CAR","CLE",20,12,8,"2006"
"1773","2006_05_DAL_PHI",2006-10-08,"PHI","DAL",38,24,14,"2006"
"1774","2006_05_DET_MIN",2006-10-08,"MIN","DET",26,17,9,"2006"
"1775","2006_05_KC_ARI",2006-10-08,"ARI","KC",20,23,-3,"2006"
"1776","2006_05_MIA_NE",2006-10-08,"NE","MIA",20,10,10,"2006"
"1777","2006_05_NYJ_JAX",2006-10-08,"JAX","NYJ",41,0,41,"2006"
"1778","2006_05_OAK_SF",2006-10-08,"SF","LV",34,20,14,"2006"
"1779","2006_05_PIT_SD",2006-10-08,"LAC","PIT",23,13,10,"2006"
"1780","2006_05_STL_GB",2006-10-08,"GB","LA",20,23,-3,"2006"
"1781","2006_05_TB_NO",2006-10-08,"NO","TB",24,21,3,"2006"
"1782","2006_05_TEN_IND",2006-10-08,"IND","TEN",14,13,1,"2006"
"1783","2006_05_WAS_NYG",2006-10-08,"NYG","WAS",19,3,16,"2006"
"1784","2006_06_BUF_DET",2006-10-15,"DET","BUF",20,17,3,"2006"
"1785","2006_06_CAR_BAL",2006-10-15,"BAL","CAR",21,23,-2,"2006"
"1786","2006_06_CHI_ARI",2006-10-16,"ARI","CHI",23,24,-1,"2006"
"1787","2006_06_CIN_TB",2006-10-15,"TB","CIN",14,13,1,"2006"
"1788","2006_06_HOU_DAL",2006-10-15,"DAL","HOU",34,6,28,"2006"
"1789","2006_06_KC_PIT",2006-10-15,"PIT","KC",45,7,38,"2006"
"1790","2006_06_MIA_NYJ",2006-10-15,"NYJ","MIA",20,17,3,"2006"
"1791","2006_06_NYG_ATL",2006-10-15,"ATL","NYG",14,27,-13,"2006"
"1792","2006_06_OAK_DEN",2006-10-15,"DEN","LV",13,3,10,"2006"
"1793","2006_06_PHI_NO",2006-10-15,"NO","PHI",27,24,3,"2006"
"1794","2006_06_SD_SF",2006-10-15,"SF","LAC",19,48,-29,"2006"
"1795","2006_06_SEA_STL",2006-10-15,"LA","SEA",28,30,-2,"2006"
"1796","2006_06_TEN_WAS",2006-10-15,"WAS","TEN",22,25,-3,"2006"
"1797","2006_07_ARI_OAK",2006-10-22,"LV","ARI",22,9,13,"2006"
"1798","2006_07_CAR_CIN",2006-10-22,"CIN","CAR",17,14,3,"2006"
"1799","2006_07_DEN_CLE",2006-10-22,"CLE","DEN",7,17,-10,"2006"
"1800","2006_07_DET_NYJ",2006-10-22,"NYJ","DET",31,24,7,"2006"
"1801","2006_07_GB_MIA",2006-10-22,"MIA","GB",24,34,-10,"2006"
"1802","2006_07_JAX_HOU",2006-10-22,"HOU","JAX",27,7,20,"2006"
"1803","2006_07_MIN_SEA",2006-10-22,"SEA","MIN",13,31,-18,"2006"
"1804","2006_07_NE_BUF",2006-10-22,"BUF","NE",6,28,-22,"2006"
"1805","2006_07_NYG_DAL",2006-10-23,"DAL","NYG",22,36,-14,"2006"
"1806","2006_07_PHI_TB",2006-10-22,"TB","PHI",23,21,2,"2006"
"1807","2006_07_PIT_ATL",2006-10-22,"ATL","PIT",41,38,3,"2006"
"1808","2006_07_SD_KC",2006-10-22,"KC","LAC",30,27,3,"2006"
"1809","2006_07_WAS_IND",2006-10-22,"IND","WAS",36,22,14,"2006"
"1810","2006_08_ARI_GB",2006-10-29,"GB","ARI",31,14,17,"2006"
"1811","2006_08_ATL_CIN",2006-10-29,"CIN","ATL",27,29,-2,"2006"
"1812","2006_08_BAL_NO",2006-10-29,"NO","BAL",22,35,-13,"2006"
"1813","2006_08_DAL_CAR",2006-10-29,"CAR","DAL",14,35,-21,"2006"
"1814","2006_08_HOU_TEN",2006-10-29,"TEN","HOU",28,22,6,"2006"
"1815","2006_08_IND_DEN",2006-10-29,"DEN","IND",31,34,-3,"2006"
"1816","2006_08_JAX_PHI",2006-10-29,"PHI","JAX",6,13,-7,"2006"
"1817","2006_08_NE_MIN",2006-10-30,"MIN","NE",7,31,-24,"2006"
"1818","2006_08_NYJ_CLE",2006-10-29,"CLE","NYJ",20,13,7,"2006"
"1819","2006_08_PIT_OAK",2006-10-29,"LV","PIT",20,13,7,"2006"
"1820","2006_08_SEA_KC",2006-10-29,"KC","SEA",35,28,7,"2006"
"1821","2006_08_SF_CHI",2006-10-29,"CHI","SF",41,10,31,"2006"
"1822","2006_08_STL_SD",2006-10-29,"LAC","LA",38,24,14,"2006"
"1823","2006_08_TB_NYG",2006-10-29,"NYG","TB",17,3,14,"2006"
"1824","2006_09_ATL_DET",2006-11-05,"DET","ATL",30,14,16,"2006"
"1825","2006_09_CIN_BAL",2006-11-05,"BAL","CIN",26,20,6,"2006"
"1826","2006_09_CLE_SD",2006-11-05,"LAC","CLE",32,25,7,"2006"
"1827","2006_09_DAL_WAS",2006-11-05,"WAS","DAL",22,19,3,"2006"
"1828","2006_09_DEN_PIT",2006-11-05,"PIT","DEN",20,31,-11,"2006"
"1829","2006_09_GB_BUF",2006-11-05,"BUF","GB",24,10,14,"2006"
"1830","2006_09_HOU_NYG",2006-11-05,"NYG","HOU",14,10,4,"2006"
"1831","2006_09_IND_NE",2006-11-05,"NE","IND",20,27,-7,"2006"
"1832","2006_09_KC_STL",2006-11-05,"LA","KC",17,31,-14,"2006"
"1833","2006_09_MIA_CHI",2006-11-05,"CHI","MIA",13,31,-18,"2006"
"1834","2006_09_MIN_SF",2006-11-05,"SF","MIN",9,3,6,"2006"
"1835","2006_09_NO_TB",2006-11-05,"TB","NO",14,31,-17,"2006"
"1836","2006_09_OAK_SEA",2006-11-06,"SEA","LV",16,0,16,"2006"
"1837","2006_09_TEN_JAX",2006-11-05,"JAX","TEN",37,7,30,"2006"
"1838","2006_10_BAL_TEN",2006-11-12,"TEN","BAL",26,27,-1,"2006"
"1839","2006_10_BUF_IND",2006-11-12,"IND","BUF",17,16,1,"2006"
"1840","2006_10_CHI_NYG",2006-11-12,"NYG","CHI",20,38,-18,"2006"
"1841","2006_10_CLE_ATL",2006-11-12,"ATL","CLE",13,17,-4,"2006"
"1842","2006_10_DAL_ARI",2006-11-12,"ARI","DAL",10,27,-17,"2006"
"1843","2006_10_DEN_OAK",2006-11-12,"LV","DEN",13,17,-4,"2006"
"1844","2006_10_GB_MIN",2006-11-12,"MIN","GB",17,23,-6,"2006"
"1845","2006_10_HOU_JAX",2006-11-12,"JAX","HOU",10,13,-3,"2006"
"1846","2006_10_KC_MIA",2006-11-12,"MIA","KC",13,10,3,"2006"
"1847","2006_10_NO_PIT",2006-11-12,"PIT","NO",38,31,7,"2006"
"1848","2006_10_NYJ_NE",2006-11-12,"NE","NYJ",14,17,-3,"2006"
"1849","2006_10_SD_CIN",2006-11-12,"CIN","LAC",41,49,-8,"2006"
"1850","2006_10_SF_DET",2006-11-12,"DET","SF",13,19,-6,"2006"
"1851","2006_10_STL_SEA",2006-11-12,"SEA","LA",24,22,2,"2006"
"1852","2006_10_TB_CAR",2006-11-13,"CAR","TB",24,10,14,"2006"
"1853","2006_10_WAS_PHI",2006-11-12,"PHI","WAS",27,3,24,"2006"
"1854","2006_11_ATL_BAL",2006-11-19,"BAL","ATL",24,10,14,"2006"
"1855","2006_11_BUF_HOU",2006-11-19,"HOU","BUF",21,24,-3,"2006"
"1856","2006_11_CHI_NYJ",2006-11-19,"NYJ","CHI",0,10,-10,"2006"
"1857","2006_11_CIN_NO",2006-11-19,"NO","CIN",16,31,-15,"2006"
"1858","2006_11_DET_ARI",2006-11-19,"ARI","DET",17,10,7,"2006"
"1859","2006_11_IND_DAL",2006-11-19,"DAL","IND",21,14,7,"2006"
"1860","2006_11_MIN_MIA",2006-11-19,"MIA","MIN",24,20,4,"2006"
"1861","2006_11_NE_GB",2006-11-19,"GB","NE",0,35,-35,"2006"
"1862","2006_11_NYG_JAX",2006-11-20,"JAX","NYG",26,10,16,"2006"
"1863","2006_11_OAK_KC",2006-11-19,"KC","LV",17,13,4,"2006"
"1864","2006_11_PIT_CLE",2006-11-19,"CLE","PIT",20,24,-4,"2006"
"1865","2006_11_SD_DEN",2006-11-19,"DEN","LAC",27,35,-8,"2006"
"1866","2006_11_SEA_SF",2006-11-19,"SF","SEA",20,14,6,"2006"
"1867","2006_11_STL_CAR",2006-11-19,"CAR","LA",15,0,15,"2006"
"1868","2006_11_TEN_PHI",2006-11-19,"PHI","TEN",13,31,-18,"2006"
"1869","2006_11_WAS_TB",2006-11-19,"TB","WAS",20,17,3,"2006"
"1870","2006_12_ARI_MIN",2006-11-26,"MIN","ARI",31,26,5,"2006"
"1871","2006_12_CAR_WAS",2006-11-26,"WAS","CAR",17,13,4,"2006"
"1872","2006_12_CHI_NE",2006-11-26,"NE","CHI",17,13,4,"2006"
"1873","2006_12_CIN_CLE",2006-11-26,"CLE","CIN",0,30,-30,"2006"
"1874","2006_12_DEN_KC",2006-11-23,"KC","DEN",19,10,9,"2006"
"1875","2006_12_GB_SEA",2006-11-27,"SEA","GB",34,24,10,"2006"
"1876","2006_12_HOU_NYJ",2006-11-26,"NYJ","HOU",26,11,15,"2006"
"1877","2006_12_JAX_BUF",2006-11-26,"BUF","JAX",27,24,3,"2006"
"1878","2006_12_MIA_DET",2006-11-23,"DET","MIA",10,27,-17,"2006"
"1879","2006_12_NO_ATL",2006-11-26,"ATL","NO",13,31,-18,"2006"
"1880","2006_12_NYG_TEN",2006-11-26,"TEN","NYG",24,21,3,"2006"
"1881","2006_12_OAK_SD",2006-11-26,"LAC","LV",21,14,7,"2006"
"1882","2006_12_PHI_IND",2006-11-26,"IND","PHI",45,21,24,"2006"
"1883","2006_12_PIT_BAL",2006-11-26,"BAL","PIT",27,0,27,"2006"
"1884","2006_12_SF_STL",2006-11-26,"LA","SF",20,17,3,"2006"
"1885","2006_12_TB_DAL",2006-11-23,"DAL","TB",38,10,28,"2006"
"1886","2006_13_ARI_STL",2006-12-03,"LA","ARI",20,34,-14,"2006"
"1887","2006_13_ATL_WAS",2006-12-03,"WAS","ATL",14,24,-10,"2006"
"1888","2006_13_BAL_CIN",2006-11-30,"CIN","BAL",13,7,6,"2006"
"1889","2006_13_CAR_PHI",2006-12-04,"PHI","CAR",27,24,3,"2006"
"1890","2006_13_DAL_NYG",2006-12-03,"NYG","DAL",20,23,-3,"2006"
"1891","2006_13_DET_NE",2006-12-03,"NE","DET",28,21,7,"2006"
"1892","2006_13_HOU_OAK",2006-12-03,"LV","HOU",14,23,-9,"2006"
"1893","2006_13_IND_TEN",2006-12-03,"TEN","IND",20,17,3,"2006"
"1894","2006_13_JAX_MIA",2006-12-03,"MIA","JAX",10,24,-14,"2006"
"1895","2006_13_KC_CLE",2006-12-03,"CLE","KC",31,28,3,"2006"
"1896","2006_13_MIN_CHI",2006-12-03,"CHI","MIN",23,13,10,"2006"
"1897","2006_13_NYJ_GB",2006-12-03,"GB","NYJ",10,38,-28,"2006"
"1898","2006_13_SD_BUF",2006-12-03,"BUF","LAC",21,24,-3,"2006"
"1899","2006_13_SEA_DEN",2006-12-03,"DEN","SEA",20,23,-3,"2006"
"1900","2006_13_SF_NO",2006-12-03,"NO","SF",34,10,24,"2006"
"1901","2006_13_TB_PIT",2006-12-03,"PIT","TB",20,3,17,"2006"
"1902","2006_14_ATL_TB",2006-12-10,"TB","ATL",6,17,-11,"2006"
"1903","2006_14_BAL_KC",2006-12-10,"KC","BAL",10,20,-10,"2006"
"1904","2006_14_BUF_NYJ",2006-12-10,"NYJ","BUF",13,31,-18,"2006"
"1905","2006_14_CHI_STL",2006-12-11,"LA","CHI",27,42,-15,"2006"
"1906","2006_14_CLE_PIT",2006-12-07,"PIT","CLE",27,7,20,"2006"
"1907","2006_14_DEN_SD",2006-12-10,"LAC","DEN",48,20,28,"2006"
"1908","2006_14_GB_SF",2006-12-10,"SF","GB",19,30,-11,"2006"
"1909","2006_14_IND_JAX",2006-12-10,"JAX","IND",44,17,27,"2006"
"1910","2006_14_MIN_DET",2006-12-10,"DET","MIN",20,30,-10,"2006"
"1911","2006_14_NE_MIA",2006-12-10,"MIA","NE",21,0,21,"2006"
"1912","2006_14_NO_DAL",2006-12-10,"DAL","NO",17,42,-25,"2006"
"1913","2006_14_NYG_CAR",2006-12-10,"CAR","NYG",13,27,-14,"2006"
"1914","2006_14_OAK_CIN",2006-12-10,"CIN","LV",27,10,17,"2006"
"1915","2006_14_PHI_WAS",2006-12-10,"WAS","PHI",19,21,-2,"2006"
"1916","2006_14_SEA_ARI",2006-12-10,"ARI","SEA",27,21,6,"2006"
"1917","2006_14_TEN_HOU",2006-12-10,"HOU","TEN",20,26,-6,"2006"
"1918","2006_15_CIN_IND",2006-12-18,"IND","CIN",34,16,18,"2006"
"1919","2006_15_CLE_BAL",2006-12-17,"BAL","CLE",27,17,10,"2006"
"1920","2006_15_DAL_ATL",2006-12-16,"ATL","DAL",28,38,-10,"2006"
"1921","2006_15_DEN_ARI",2006-12-17,"ARI","DEN",20,37,-17,"2006"
"1922","2006_15_DET_GB",2006-12-17,"GB","DET",17,9,8,"2006"
"1923","2006_15_HOU_NE",2006-12-17,"NE","HOU",40,7,33,"2006"
"1924","2006_15_JAX_TEN",2006-12-17,"TEN","JAX",24,17,7,"2006"
"1925","2006_15_KC_SD",2006-12-17,"LAC","KC",20,9,11,"2006"
"1926","2006_15_MIA_BUF",2006-12-17,"BUF","MIA",21,0,21,"2006"
"1927","2006_15_NYJ_MIN",2006-12-17,"MIN","NYJ",13,26,-13,"2006"
"1928","2006_15_PHI_NYG",2006-12-17,"NYG","PHI",22,36,-14,"2006"
"1929","2006_15_PIT_CAR",2006-12-17,"CAR","PIT",3,37,-34,"2006"
"1930","2006_15_SF_SEA",2006-12-14,"SEA","SF",14,24,-10,"2006"
"1931","2006_15_STL_OAK",2006-12-17,"LV","LA",0,20,-20,"2006"
"1932","2006_15_TB_CHI",2006-12-17,"CHI","TB",34,31,3,"2006"
"1933","2006_15_WAS_NO",2006-12-17,"NO","WAS",10,16,-6,"2006"
"1934","2006_16_ARI_SF",2006-12-24,"SF","ARI",20,26,-6,"2006"
"1935","2006_16_BAL_PIT",2006-12-24,"PIT","BAL",7,31,-24,"2006"
"1936","2006_16_CAR_ATL",2006-12-24,"ATL","CAR",3,10,-7,"2006"
"1937","2006_16_CHI_DET",2006-12-24,"DET","CHI",21,26,-5,"2006"
"1938","2006_16_CIN_DEN",2006-12-24,"DEN","CIN",24,23,1,"2006"
"1939","2006_16_IND_HOU",2006-12-24,"HOU","IND",27,24,3,"2006"
"1940","2006_16_KC_OAK",2006-12-23,"LV","KC",9,20,-11,"2006"
"1941","2006_16_MIN_GB",2006-12-21,"GB","MIN",9,7,2,"2006"
"1942","2006_16_NE_JAX",2006-12-24,"JAX","NE",21,24,-3,"2006"
"1943","2006_16_NO_NYG",2006-12-24,"NYG","NO",7,30,-23,"2006"
"1944","2006_16_NYJ_MIA",2006-12-25,"MIA","NYJ",10,13,-3,"2006"
"1945","2006_16_PHI_DAL",2006-12-25,"DAL","PHI",7,23,-16,"2006"
"1946","2006_16_SD_SEA",2006-12-24,"SEA","LAC",17,20,-3,"2006"
"1947","2006_16_TB_CLE",2006-12-24,"CLE","TB",7,22,-15,"2006"
"1948","2006_16_TEN_BUF",2006-12-24,"BUF","TEN",29,30,-1,"2006"
"1949","2006_16_WAS_STL",2006-12-24,"LA","WAS",37,31,6,"2006"
"1950","2006_17_ARI_SD",2006-12-31,"LAC","ARI",27,20,7,"2006"
"1951","2006_17_ATL_PHI",2006-12-31,"PHI","ATL",24,17,7,"2006"
"1952","2006_17_BUF_BAL",2006-12-31,"BAL","BUF",19,7,12,"2006"
"1953","2006_17_CAR_NO",2006-12-31,"NO","CAR",21,31,-10,"2006"
"1954","2006_17_CLE_HOU",2006-12-31,"HOU","CLE",14,6,8,"2006"
"1955","2006_17_DET_DAL",2006-12-31,"DAL","DET",31,39,-8,"2006"
"1956","2006_17_GB_CHI",2006-12-31,"CHI","GB",7,26,-19,"2006"
"1957","2006_17_JAX_KC",2006-12-31,"KC","JAX",35,30,5,"2006"
"1958","2006_17_MIA_IND",2006-12-31,"IND","MIA",27,22,5,"2006"
"1959","2006_17_NE_TEN",2006-12-31,"TEN","NE",23,40,-17,"2006"
"1960","2006_17_NYG_WAS",2006-12-30,"WAS","NYG",28,34,-6,"2006"
"1961","2006_17_OAK_NYJ",2006-12-31,"NYJ","LV",23,3,20,"2006"
"1962","2006_17_PIT_CIN",2006-12-31,"CIN","PIT",17,23,-6,"2006"
"1963","2006_17_SEA_TB",2006-12-31,"TB","SEA",7,23,-16,"2006"
"1964","2006_17_SF_DEN",2006-12-31,"DEN","SF",23,26,-3,"2006"
"1965","2006_17_STL_MIN",2006-12-31,"MIN","LA",21,41,-20,"2006"
"1966","2007_01_ARI_SF",2007-09-10,"SF","ARI",20,17,3,"2007"
"1967","2007_01_ATL_MIN",2007-09-09,"MIN","ATL",24,3,21,"2007"
"1968","2007_01_BAL_CIN",2007-09-10,"CIN","BAL",27,20,7,"2007"
"1969","2007_01_CAR_STL",2007-09-09,"LA","CAR",13,27,-14,"2007"
"1970","2007_01_CHI_SD",2007-09-09,"LAC","CHI",14,3,11,"2007"
"1971","2007_01_DEN_BUF",2007-09-09,"BUF","DEN",14,15,-1,"2007"
"1972","2007_01_DET_OAK",2007-09-09,"LV","DET",21,36,-15,"2007"
"1973","2007_01_KC_HOU",2007-09-09,"HOU","KC",20,3,17,"2007"
"1974","2007_01_MIA_WAS",2007-09-09,"WAS","MIA",16,13,3,"2007"
"1975","2007_01_NE_NYJ",2007-09-09,"NYJ","NE",14,38,-24,"2007"
"1976","2007_01_NO_IND",2007-09-06,"IND","NO",41,10,31,"2007"
"1977","2007_01_NYG_DAL",2007-09-09,"DAL","NYG",45,35,10,"2007"
"1978","2007_01_PHI_GB",2007-09-09,"GB","PHI",16,13,3,"2007"
"1979","2007_01_PIT_CLE",2007-09-09,"CLE","PIT",7,34,-27,"2007"
"1980","2007_01_TB_SEA",2007-09-09,"SEA","TB",20,6,14,"2007"
"1981","2007_01_TEN_JAX",2007-09-09,"JAX","TEN",10,13,-3,"2007"
"1982","2007_02_ATL_JAX",2007-09-16,"JAX","ATL",13,7,6,"2007"
"1983","2007_02_BUF_PIT",2007-09-16,"PIT","BUF",26,3,23,"2007"
"1984","2007_02_CIN_CLE",2007-09-16,"CLE","CIN",51,45,6,"2007"
"1985","2007_02_DAL_MIA",2007-09-16,"MIA","DAL",20,37,-17,"2007"
"1986","2007_02_GB_NYG",2007-09-16,"NYG","GB",13,35,-22,"2007"
"1987","2007_02_HOU_CAR",2007-09-16,"CAR","HOU",21,34,-13,"2007"
"1988","2007_02_IND_TEN",2007-09-16,"TEN","IND",20,22,-2,"2007"
"1989","2007_02_KC_CHI",2007-09-16,"CHI","KC",20,10,10,"2007"
"1990","2007_02_MIN_DET",2007-09-16,"DET","MIN",20,17,3,"2007"
"1991","2007_02_NO_TB",2007-09-16,"TB","NO",31,14,17,"2007"
"1992","2007_02_NYJ_BAL",2007-09-16,"BAL","NYJ",20,13,7,"2007"
"1993","2007_02_OAK_DEN",2007-09-16,"DEN","LV",23,20,3,"2007"
"1994","2007_02_SD_NE",2007-09-16,"NE","LAC",38,14,24,"2007"
"1995","2007_02_SEA_ARI",2007-09-16,"ARI","SEA",23,20,3,"2007"
"1996","2007_02_SF_STL",2007-09-16,"LA","SF",16,17,-1,"2007"
"1997","2007_02_WAS_PHI",2007-09-17,"PHI","WAS",12,20,-8,"2007"
"1998","2007_03_ARI_BAL",2007-09-23,"BAL","ARI",26,23,3,"2007"
"1999","2007_03_BUF_NE",2007-09-23,"NE","BUF",38,7,31,"2007"
"2000","2007_03_CAR_ATL",2007-09-23,"ATL","CAR",20,27,-7,"2007"
"2001","2007_03_CIN_SEA",2007-09-23,"SEA","CIN",24,21,3,"2007"
"2002","2007_03_CLE_OAK",2007-09-23,"LV","CLE",26,24,2,"2007"
"2003","2007_03_DAL_CHI",2007-09-23,"CHI","DAL",10,34,-24,"2007"
"2004","2007_03_DET_PHI",2007-09-23,"PHI","DET",56,21,35,"2007"
"2005","2007_03_IND_HOU",2007-09-23,"HOU","IND",24,30,-6,"2007"
"2006","2007_03_JAX_DEN",2007-09-23,"DEN","JAX",14,23,-9,"2007"
"2007","2007_03_MIA_NYJ",2007-09-23,"NYJ","MIA",31,28,3,"2007"
"2008","2007_03_MIN_KC",2007-09-23,"KC","MIN",13,10,3,"2007"
"2009","2007_03_NYG_WAS",2007-09-23,"WAS","NYG",17,24,-7,"2007"
"2010","2007_03_SD_GB",2007-09-23,"GB","LAC",31,24,7,"2007"
"2011","2007_03_SF_PIT",2007-09-23,"PIT","SF",37,16,21,"2007"
"2012","2007_03_STL_TB",2007-09-23,"TB","LA",24,3,21,"2007"
"2013","2007_03_TEN_NO",2007-09-24,"NO","TEN",14,31,-17,"2007"
"2014","2007_04_BAL_CLE",2007-09-30,"CLE","BAL",27,13,14,"2007"
"2015","2007_04_CHI_DET",2007-09-30,"DET","CHI",37,27,10,"2007"
"2016","2007_04_DEN_IND",2007-09-30,"IND","DEN",38,20,18,"2007"
"2017","2007_04_GB_MIN",2007-09-30,"MIN","GB",16,23,-7,"2007"
"2018","2007_04_HOU_ATL",2007-09-30,"ATL","HOU",26,16,10,"2007"
"2019","2007_04_KC_SD",2007-09-30,"LAC","KC",16,30,-14,"2007"
"2020","2007_04_NE_CIN",2007-10-01,"CIN","NE",13,34,-21,"2007"
"2021","2007_04_NYJ_BUF",2007-09-30,"BUF","NYJ",17,14,3,"2007"
"2022","2007_04_OAK_MIA",2007-09-30,"MIA","LV",17,35,-18,"2007"
"2023","2007_04_PHI_NYG",2007-09-30,"NYG","PHI",16,3,13,"2007"
"2024","2007_04_PIT_ARI",2007-09-30,"ARI","PIT",21,14,7,"2007"
"2025","2007_04_SEA_SF",2007-09-30,"SF","SEA",3,23,-20,"2007"
"2026","2007_04_STL_DAL",2007-09-30,"DAL","LA",35,7,28,"2007"
"2027","2007_04_TB_CAR",2007-09-30,"CAR","TB",7,20,-13,"2007"
"2028","2007_05_ARI_STL",2007-10-07,"LA","ARI",31,34,-3,"2007"
"2029","2007_05_ATL_TEN",2007-10-07,"TEN","ATL",20,13,7,"2007"
"2030","2007_05_BAL_SF",2007-10-07,"SF","BAL",7,9,-2,"2007"
"2031","2007_05_CAR_NO",2007-10-07,"NO","CAR",13,16,-3,"2007"
"2032","2007_05_CHI_GB",2007-10-07,"GB","CHI",20,27,-7,"2007"
"2033","2007_05_CLE_NE",2007-10-07,"NE","CLE",34,17,17,"2007"
"2034","2007_05_DAL_BUF",2007-10-08,"BUF","DAL",24,25,-1,"2007"
"2035","2007_05_DET_WAS",2007-10-07,"WAS","DET",34,3,31,"2007"
"2036","2007_05_JAX_KC",2007-10-07,"KC","JAX",7,17,-10,"2007"
"2037","2007_05_MIA_HOU",2007-10-07,"HOU","MIA",22,19,3,"2007"
"2038","2007_05_NYJ_NYG",2007-10-07,"NYG","NYJ",35,24,11,"2007"
"2039","2007_05_SD_DEN",2007-10-07,"DEN","LAC",3,41,-38,"2007"
"2040","2007_05_SEA_PIT",2007-10-07,"PIT","SEA",21,0,21,"2007"
"2041","2007_05_TB_IND",2007-10-07,"IND","TB",33,14,19,"2007"
"2042","2007_06_CAR_ARI",2007-10-14,"ARI","CAR",10,25,-15,"2007"
"2043","2007_06_CIN_KC",2007-10-14,"KC","CIN",27,20,7,"2007"
"2044","2007_06_HOU_JAX",2007-10-14,"JAX","HOU",37,17,20,"2007"
"2045","2007_06_MIA_CLE",2007-10-14,"CLE","MIA",41,31,10,"2007"
"2046","2007_06_MIN_CHI",2007-10-14,"CHI","MIN",31,34,-3,"2007"
"2047","2007_06_NE_DAL",2007-10-14,"DAL","NE",27,48,-21,"2007"
"2048","2007_06_NO_SEA",2007-10-14,"SEA","NO",17,28,-11,"2007"
"2049","2007_06_NYG_ATL",2007-10-15,"ATL","NYG",10,31,-21,"2007"
"2050","2007_06_OAK_SD",2007-10-14,"LAC","LV",28,14,14,"2007"
"2051","2007_06_PHI_NYJ",2007-10-14,"NYJ","PHI",9,16,-7,"2007"
"2052","2007_06_STL_BAL",2007-10-14,"BAL","LA",22,3,19,"2007"
"2053","2007_06_TEN_TB",2007-10-14,"TB","TEN",13,10,3,"2007"
"2054","2007_06_WAS_GB",2007-10-14,"GB","WAS",17,14,3,"2007"
"2055","2007_07_ARI_WAS",2007-10-21,"WAS","ARI",21,19,2,"2007"
"2056","2007_07_ATL_NO",2007-10-21,"NO","ATL",22,16,6,"2007"
"2057","2007_07_BAL_BUF",2007-10-21,"BUF","BAL",19,14,5,"2007"
"2058","2007_07_CHI_PHI",2007-10-21,"PHI","CHI",16,19,-3,"2007"
"2059","2007_07_IND_JAX",2007-10-22,"JAX","IND",7,29,-22,"2007"
"2060","2007_07_KC_OAK",2007-10-21,"LV","KC",10,12,-2,"2007"
"2061","2007_07_MIN_DAL",2007-10-21,"DAL","MIN",24,14,10,"2007"
"2062","2007_07_NE_MIA",2007-10-21,"MIA","NE",28,49,-21,"2007"
"2063","2007_07_NYJ_CIN",2007-10-21,"CIN","NYJ",38,31,7,"2007"
"2064","2007_07_PIT_DEN",2007-10-21,"DEN","PIT",31,28,3,"2007"
"2065","2007_07_SF_NYG",2007-10-21,"NYG","SF",33,15,18,"2007"
"2066","2007_07_STL_SEA",2007-10-21,"SEA","LA",33,6,27,"2007"
"2067","2007_07_TB_DET",2007-10-21,"DET","TB",23,16,7,"2007"
"2068","2007_07_TEN_HOU",2007-10-21,"HOU","TEN",36,38,-2,"2007"
"2069","2007_08_BUF_NYJ",2007-10-28,"NYJ","BUF",3,13,-10,"2007"
"2070","2007_08_CLE_STL",2007-10-28,"LA","CLE",20,27,-7,"2007"
"2071","2007_08_DET_CHI",2007-10-28,"CHI","DET",7,16,-9,"2007"
"2072","2007_08_GB_DEN",2007-10-29,"DEN","GB",13,19,-6,"2007"
"2073","2007_08_HOU_SD",2007-10-28,"LAC","HOU",35,10,25,"2007"
"2074","2007_08_IND_CAR",2007-10-28,"CAR","IND",7,31,-24,"2007"
"2075","2007_08_JAX_TB",2007-10-28,"TB","JAX",23,24,-1,"2007"
"2076","2007_08_NO_SF",2007-10-28,"SF","NO",10,31,-21,"2007"
"2077","2007_08_NYG_MIA",2007-10-28,"MIA","NYG",10,13,-3,"2007"
"2078","2007_08_OAK_TEN",2007-10-28,"TEN","LV",13,9,4,"2007"
"2079","2007_08_PHI_MIN",2007-10-28,"MIN","PHI",16,23,-7,"2007"
"2080","2007_08_PIT_CIN",2007-10-28,"CIN","PIT",13,24,-11,"2007"
"2081","2007_08_WAS_NE",2007-10-28,"NE","WAS",52,7,45,"2007"
"2082","2007_09_ARI_TB",2007-11-04,"TB","ARI",17,10,7,"2007"
"2083","2007_09_BAL_PIT",2007-11-05,"PIT","BAL",38,7,31,"2007"
"2084","2007_09_CAR_TEN",2007-11-04,"TEN","CAR",20,7,13,"2007"
"2085","2007_09_CIN_BUF",2007-11-04,"BUF","CIN",33,21,12,"2007"
"2086","2007_09_DAL_PHI",2007-11-04,"PHI","DAL",17,38,-21,"2007"
"2087","2007_09_DEN_DET",2007-11-04,"DET","DEN",44,7,37,"2007"
"2088","2007_09_GB_KC",2007-11-04,"KC","GB",22,33,-11,"2007"
"2089","2007_09_HOU_OAK",2007-11-04,"LV","HOU",17,24,-7,"2007"
"2090","2007_09_JAX_NO",2007-11-04,"NO","JAX",41,24,17,"2007"
"2091","2007_09_NE_IND",2007-11-04,"IND","NE",20,24,-4,"2007"
"2092","2007_09_SD_MIN",2007-11-04,"MIN","LAC",35,17,18,"2007"
"2093","2007_09_SEA_CLE",2007-11-04,"CLE","SEA",33,30,3,"2007"
"2094","2007_09_SF_ATL",2007-11-04,"ATL","SF",20,16,4,"2007"
"2095","2007_09_WAS_NYJ",2007-11-04,"NYJ","WAS",20,23,-3,"2007"
"2096","2007_10_ATL_CAR",2007-11-11,"CAR","ATL",13,20,-7,"2007"
"2097","2007_10_BUF_MIA",2007-11-11,"MIA","BUF",10,13,-3,"2007"
"2098","2007_10_CHI_OAK",2007-11-11,"LV","CHI",6,17,-11,"2007"
"2099","2007_10_CIN_BAL",2007-11-11,"BAL","CIN",7,21,-14,"2007"
"2100","2007_10_CLE_PIT",2007-11-11,"PIT","CLE",31,28,3,"2007"
"2101","2007_10_DAL_NYG",2007-11-11,"NYG","DAL",20,31,-11,"2007"
"2102","2007_10_DEN_KC",2007-11-11,"KC","DEN",11,27,-16,"2007"
"2103","2007_10_DET_ARI",2007-11-11,"ARI","DET",31,21,10,"2007"
"2104","2007_10_IND_SD",2007-11-11,"LAC","IND",23,21,2,"2007"
"2105","2007_10_JAX_TEN",2007-11-11,"TEN","JAX",13,28,-15,"2007"
"2106","2007_10_MIN_GB",2007-11-11,"GB","MIN",34,0,34,"2007"
"2107","2007_10_PHI_WAS",2007-11-11,"WAS","PHI",25,33,-8,"2007"
"2108","2007_10_SF_SEA",2007-11-12,"SEA","SF",24,0,24,"2007"
"2109","2007_10_STL_NO",2007-11-11,"NO","LA",29,37,-8,"2007"
"2110","2007_11_ARI_CIN",2007-11-18,"CIN","ARI",27,35,-8,"2007"
"2111","2007_11_CAR_GB",2007-11-18,"GB","CAR",31,17,14,"2007"
"2112","2007_11_CHI_SEA",2007-11-18,"SEA","CHI",30,23,7,"2007"
"2113","2007_11_CLE_BAL",2007-11-18,"BAL","CLE",30,33,-3,"2007"
"2114","2007_11_KC_IND",2007-11-18,"IND","KC",13,10,3,"2007"
"2115","2007_11_MIA_PHI",2007-11-18,"PHI","MIA",17,7,10,"2007"
"2116","2007_11_NE_BUF",2007-11-18,"BUF","NE",10,56,-46,"2007"
"2117","2007_11_NO_HOU",2007-11-18,"HOU","NO",23,10,13,"2007"
"2118","2007_11_NYG_DET",2007-11-18,"DET","NYG",10,16,-6,"2007"
"2119","2007_11_OAK_MIN",2007-11-18,"MIN","LV",29,22,7,"2007"
"2120","2007_11_PIT_NYJ",2007-11-18,"NYJ","PIT",19,16,3,"2007"
"2121","2007_11_SD_JAX",2007-11-18,"JAX","LAC",24,17,7,"2007"
"2122","2007_11_STL_SF",2007-11-18,"SF","LA",9,13,-4,"2007"
"2123","2007_11_TB_ATL",2007-11-18,"ATL","TB",7,31,-24,"2007"
"2124","2007_11_TEN_DEN",2007-11-19,"DEN","TEN",34,20,14,"2007"
"2125","2007_11_WAS_DAL",2007-11-18,"DAL","WAS",28,23,5,"2007"
"2126","2007_12_BAL_SD",2007-11-25,"LAC","BAL",32,14,18,"2007"
"2127","2007_12_BUF_JAX",2007-11-25,"JAX","BUF",36,14,22,"2007"
"2128","2007_12_DEN_CHI",2007-11-25,"CHI","DEN",37,34,3,"2007"
"2129","2007_12_GB_DET",2007-11-22,"DET","GB",26,37,-11,"2007"
"2130","2007_12_HOU_CLE",2007-11-25,"CLE","HOU",27,17,10,"2007"
"2131","2007_12_IND_ATL",2007-11-22,"ATL","IND",13,31,-18,"2007"
"2132","2007_12_MIA_PIT",2007-11-26,"PIT","MIA",3,0,3,"2007"
"2133","2007_12_MIN_NYG",2007-11-25,"NYG","MIN",17,41,-24,"2007"
"2134","2007_12_NO_CAR",2007-11-25,"CAR","NO",6,31,-25,"2007"
"2135","2007_12_NYJ_DAL",2007-11-22,"DAL","NYJ",34,3,31,"2007"
"2136","2007_12_OAK_KC",2007-11-25,"KC","LV",17,20,-3,"2007"
"2137","2007_12_PHI_NE",2007-11-25,"NE","PHI",31,28,3,"2007"
"2138","2007_12_SEA_STL",2007-11-25,"LA","SEA",19,24,-5,"2007"
"2139","2007_12_SF_ARI",2007-11-25,"ARI","SF",31,37,-6,"2007"
"2140","2007_12_TEN_CIN",2007-11-25,"CIN","TEN",35,6,29,"2007"
"2141","2007_12_WAS_TB",2007-11-25,"TB","WAS",19,13,6,"2007"
"2142","2007_13_ATL_STL",2007-12-02,"LA","ATL",28,16,12,"2007"
"2143","2007_13_BUF_WAS",2007-12-02,"WAS","BUF",16,17,-1,"2007"
"2144","2007_13_CIN_PIT",2007-12-02,"PIT","CIN",24,10,14,"2007"
"2145","2007_13_CLE_ARI",2007-12-02,"ARI","CLE",27,21,6,"2007"
"2146","2007_13_DEN_OAK",2007-12-02,"LV","DEN",34,20,14,"2007"
"2147","2007_13_DET_MIN",2007-12-02,"MIN","DET",42,10,32,"2007"
"2148","2007_13_GB_DAL",2007-11-29,"DAL","GB",37,27,10,"2007"
"2149","2007_13_HOU_TEN",2007-12-02,"TEN","HOU",28,20,8,"2007"
"2150","2007_13_JAX_IND",2007-12-02,"IND","JAX",28,25,3,"2007"
"2151","2007_13_NE_BAL",2007-12-03,"BAL","NE",24,27,-3,"2007"
"2152","2007_13_NYG_CHI",2007-12-02,"CHI","NYG",16,21,-5,"2007"
"2153","2007_13_NYJ_MIA",2007-12-02,"MIA","NYJ",13,40,-27,"2007"
"2154","2007_13_SD_KC",2007-12-02,"KC","LAC",10,24,-14,"2007"
"2155","2007_13_SEA_PHI",2007-12-02,"PHI","SEA",24,28,-4,"2007"
"2156","2007_13_SF_CAR",2007-12-02,"CAR","SF",31,14,17,"2007"
"2157","2007_13_TB_NO",2007-12-02,"NO","TB",23,27,-4,"2007"
"2158","2007_14_ARI_SEA",2007-12-09,"SEA","ARI",42,21,21,"2007"
"2159","2007_14_CAR_JAX",2007-12-09,"JAX","CAR",37,6,31,"2007"
"2160","2007_14_CHI_WAS",2007-12-06,"WAS","CHI",24,16,8,"2007"
"2161","2007_14_CLE_NYJ",2007-12-09,"NYJ","CLE",18,24,-6,"2007"
"2162","2007_14_DAL_DET",2007-12-09,"DET","DAL",27,28,-1,"2007"
"2163","2007_14_IND_BAL",2007-12-09,"BAL","IND",20,44,-24,"2007"
"2164","2007_14_KC_DEN",2007-12-09,"DEN","KC",41,7,34,"2007"
"2165","2007_14_MIA_BUF",2007-12-09,"BUF","MIA",38,17,21,"2007"
"2166","2007_14_MIN_SF",2007-12-09,"SF","MIN",7,27,-20,"2007"
"2167","2007_14_NO_ATL",2007-12-10,"ATL","NO",14,34,-20,"2007"
"2168","2007_14_NYG_PHI",2007-12-09,"PHI","NYG",13,16,-3,"2007"
"2169","2007_14_OAK_GB",2007-12-09,"GB","LV",38,7,31,"2007"
"2170","2007_14_PIT_NE",2007-12-09,"NE","PIT",34,13,21,"2007"
"2171","2007_14_SD_TEN",2007-12-09,"TEN","LAC",17,23,-6,"2007"
"2172","2007_14_STL_CIN",2007-12-09,"CIN","LA",19,10,9,"2007"
"2173","2007_14_TB_HOU",2007-12-09,"HOU","TB",28,14,14,"2007"
"2174","2007_15_ARI_NO",2007-12-16,"NO","ARI",31,24,7,"2007"
"2175","2007_15_ATL_TB",2007-12-16,"TB","ATL",37,3,34,"2007"
"2176","2007_15_BAL_MIA",2007-12-16,"MIA","BAL",22,16,6,"2007"
"2177","2007_15_BUF_CLE",2007-12-16,"CLE","BUF",8,0,8,"2007"
"2178","2007_15_CHI_MIN",2007-12-17,"MIN","CHI",20,13,7,"2007"
"2179","2007_15_CIN_SF",2007-12-15,"SF","CIN",20,13,7,"2007"
"2180","2007_15_DEN_HOU",2007-12-13,"HOU","DEN",31,13,18,"2007"
"2181","2007_15_DET_SD",2007-12-16,"LAC","DET",51,14,37,"2007"
"2182","2007_15_GB_STL",2007-12-16,"LA","GB",14,33,-19,"2007"
"2183","2007_15_IND_OAK",2007-12-16,"LV","IND",14,21,-7,"2007"
"2184","2007_15_JAX_PIT",2007-12-16,"PIT","JAX",22,29,-7,"2007"
"2185","2007_15_NYJ_NE",2007-12-16,"NE","NYJ",20,10,10,"2007"
"2186","2007_15_PHI_DAL",2007-12-16,"DAL","PHI",6,10,-4,"2007"
"2187","2007_15_SEA_CAR",2007-12-16,"CAR","SEA",13,10,3,"2007"
"2188","2007_15_TEN_KC",2007-12-16,"KC","TEN",17,26,-9,"2007"
"2189","2007_15_WAS_NYG",2007-12-16,"NYG","WAS",10,22,-12,"2007"
"2190","2007_16_ATL_ARI",2007-12-23,"ARI","ATL",30,27,3,"2007"
"2191","2007_16_BAL_SEA",2007-12-23,"SEA","BAL",27,6,21,"2007"
"2192","2007_16_CLE_CIN",2007-12-23,"CIN","CLE",19,14,5,"2007"
"2193","2007_16_DAL_CAR",2007-12-22,"CAR","DAL",13,20,-7,"2007"
"2194","2007_16_DEN_SD",2007-12-24,"LAC","DEN",23,3,20,"2007"
"2195","2007_16_GB_CHI",2007-12-23,"CHI","GB",35,7,28,"2007"
"2196","2007_16_HOU_IND",2007-12-23,"IND","HOU",38,15,23,"2007"
"2197","2007_16_KC_DET",2007-12-23,"DET","KC",25,20,5,"2007"
"2198","2007_16_MIA_NE",2007-12-23,"NE","MIA",28,7,21,"2007"
"2199","2007_16_NYG_BUF",2007-12-23,"BUF","NYG",21,38,-17,"2007"
"2200","2007_16_NYJ_TEN",2007-12-23,"TEN","NYJ",10,6,4,"2007"
"2201","2007_16_OAK_JAX",2007-12-23,"JAX","LV",49,11,38,"2007"
"2202","2007_16_PHI_NO",2007-12-23,"NO","PHI",23,38,-15,"2007"
"2203","2007_16_PIT_STL",2007-12-20,"LA","PIT",24,41,-17,"2007"
"2204","2007_16_TB_SF",2007-12-23,"SF","TB",21,19,2,"2007"
"2205","2007_16_WAS_MIN",2007-12-23,"MIN","WAS",21,32,-11,"2007"
"2206","2007_17_BUF_PHI",2007-12-30,"PHI","BUF",17,9,8,"2007"
"2207","2007_17_CAR_TB",2007-12-30,"TB","CAR",23,31,-8,"2007"
"2208","2007_17_CIN_MIA",2007-12-30,"MIA","CIN",25,38,-13,"2007"
"2209","2007_17_DAL_WAS",2007-12-30,"WAS","DAL",27,6,21,"2007"
"2210","2007_17_DET_GB",2007-12-30,"GB","DET",34,13,21,"2007"
"2211","2007_17_JAX_HOU",2007-12-30,"HOU","JAX",42,28,14,"2007"
"2212","2007_17_KC_NYJ",2007-12-30,"NYJ","KC",13,10,3,"2007"
"2213","2007_17_MIN_DEN",2007-12-30,"DEN","MIN",22,19,3,"2007"
"2214","2007_17_NE_NYG",2007-12-29,"NYG","NE",35,38,-3,"2007"
"2215","2007_17_NO_CHI",2007-12-30,"CHI","NO",33,25,8,"2007"
"2216","2007_17_PIT_BAL",2007-12-30,"BAL","PIT",27,21,6,"2007"
"2217","2007_17_SD_OAK",2007-12-30,"LV","LAC",17,30,-13,"2007"
"2218","2007_17_SEA_ATL",2007-12-30,"ATL","SEA",44,41,3,"2007"
"2219","2007_17_SF_CLE",2007-12-30,"CLE","SF",20,7,13,"2007"
"2220","2007_17_STL_ARI",2007-12-30,"ARI","LA",48,19,29,"2007"
"2221","2007_17_TEN_IND",2007-12-30,"IND","TEN",10,16,-6,"2007"
"2222","2008_01_ARI_SF",2008-09-07,"SF","ARI",13,23,-10,"2008"
"2223","2008_01_CAR_SD",2008-09-07,"LAC","CAR",24,26,-2,"2008"
"2224","2008_01_CHI_IND",2008-09-07,"IND","CHI",13,29,-16,"2008"
"2225","2008_01_CIN_BAL",2008-09-07,"BAL","CIN",17,10,7,"2008"
"2226","2008_01_DAL_CLE",2008-09-07,"CLE","DAL",10,28,-18,"2008"
"2227","2008_01_DEN_OAK",2008-09-08,"LV","DEN",14,41,-27,"2008"
"2228","2008_01_DET_ATL",2008-09-07,"ATL","DET",34,21,13,"2008"
"2229","2008_01_HOU_PIT",2008-09-07,"PIT","HOU",38,17,21,"2008"
"2230","2008_01_JAX_TEN",2008-09-07,"TEN","JAX",17,10,7,"2008"
"2231","2008_01_KC_NE",2008-09-07,"NE","KC",17,10,7,"2008"
"2232","2008_01_MIN_GB",2008-09-08,"GB","MIN",24,19,5,"2008"
"2233","2008_01_NYJ_MIA",2008-09-07,"MIA","NYJ",14,20,-6,"2008"
"2234","2008_01_SEA_BUF",2008-09-07,"BUF","SEA",34,10,24,"2008"
"2235","2008_01_STL_PHI",2008-09-07,"PHI","LA",38,3,35,"2008"
"2236","2008_01_TB_NO",2008-09-07,"NO","TB",24,20,4,"2008"
"2237","2008_01_WAS_NYG",2008-09-04,"NYG","WAS",16,7,9,"2008"
"2238","2008_02_ATL_TB",2008-09-14,"TB","ATL",24,9,15,"2008"
"2239","2008_02_BUF_JAX",2008-09-14,"JAX","BUF",16,20,-4,"2008"
"2240","2008_02_CHI_CAR",2008-09-14,"CAR","CHI",20,17,3,"2008"
"2241","2008_02_GB_DET",2008-09-14,"DET","GB",25,48,-23,"2008"
"2242","2008_02_IND_MIN",2008-09-14,"MIN","IND",15,18,-3,"2008"
"2243","2008_02_MIA_ARI",2008-09-14,"ARI","MIA",31,10,21,"2008"
"2244","2008_02_NE_NYJ",2008-09-14,"NYJ","NE",10,19,-9,"2008"
"2245","2008_02_NO_WAS",2008-09-14,"WAS","NO",29,24,5,"2008"
"2246","2008_02_NYG_STL",2008-09-14,"LA","NYG",13,41,-28,"2008"
"2247","2008_02_OAK_KC",2008-09-14,"KC","LV",8,23,-15,"2008"
"2248","2008_02_PHI_DAL",2008-09-15,"DAL","PHI",41,37,4,"2008"
"2249","2008_02_PIT_CLE",2008-09-14,"CLE","PIT",6,10,-4,"2008"
"2250","2008_02_SD_DEN",2008-09-14,"DEN","LAC",39,38,1,"2008"
"2251","2008_02_SF_SEA",2008-09-14,"SEA","SF",30,33,-3,"2008"
"2252","2008_02_TEN_CIN",2008-09-14,"CIN","TEN",7,24,-17,"2008"
"2253","2008_03_ARI_WAS",2008-09-21,"WAS","ARI",24,17,7,"2008"
"2254","2008_03_CAR_MIN",2008-09-21,"MIN","CAR",20,10,10,"2008"
"2255","2008_03_CIN_NYG",2008-09-21,"NYG","CIN",26,23,3,"2008"
"2256","2008_03_CLE_BAL",2008-09-21,"BAL","CLE",28,10,18,"2008"
"2257","2008_03_DAL_GB",2008-09-21,"GB","DAL",16,27,-11,"2008"
"2258","2008_03_DET_SF",2008-09-21,"SF","DET",31,13,18,"2008"
"2259","2008_03_HOU_TEN",2008-09-21,"TEN","HOU",31,12,19,"2008"
"2260","2008_03_JAX_IND",2008-09-21,"IND","JAX",21,23,-2,"2008"
"2261","2008_03_KC_ATL",2008-09-21,"ATL","KC",38,14,24,"2008"
"2262","2008_03_MIA_NE",2008-09-21,"NE","MIA",13,38,-25,"2008"
"2263","2008_03_NO_DEN",2008-09-21,"DEN","NO",34,32,2,"2008"
"2264","2008_03_NYJ_SD",2008-09-22,"LAC","NYJ",48,29,19,"2008"
"2265","2008_03_OAK_BUF",2008-09-21,"BUF","LV",24,23,1,"2008"
"2266","2008_03_PIT_PHI",2008-09-21,"PHI","PIT",15,6,9,"2008"
"2267","2008_03_STL_SEA",2008-09-21,"SEA","LA",37,13,24,"2008"
"2268","2008_03_TB_CHI",2008-09-21,"CHI","TB",24,27,-3,"2008"
"2269","2008_04_ARI_NYJ",2008-09-28,"NYJ","ARI",56,35,21,"2008"
"2270","2008_04_ATL_CAR",2008-09-28,"CAR","ATL",24,9,15,"2008"
"2271","2008_04_BAL_PIT",2008-09-29,"PIT","BAL",23,20,3,"2008"
"2272","2008_04_BUF_STL",2008-09-28,"LA","BUF",14,31,-17,"2008"
"2273","2008_04_CLE_CIN",2008-09-28,"CIN","CLE",12,20,-8,"2008"
"2274","2008_04_DEN_KC",2008-09-28,"KC","DEN",33,19,14,"2008"
"2275","2008_04_GB_TB",2008-09-28,"TB","GB",30,21,9,"2008"
"2276","2008_04_HOU_JAX",2008-09-28,"JAX","HOU",30,27,3,"2008"
"2277","2008_04_MIN_TEN",2008-09-28,"TEN","MIN",30,17,13,"2008"
"2278","2008_04_PHI_CHI",2008-09-28,"CHI","PHI",24,20,4,"2008"
"2279","2008_04_SD_OAK",2008-09-28,"LV","LAC",18,28,-10,"2008"
"2280","2008_04_SF_NO",2008-09-28,"NO","SF",31,17,14,"2008"
"2281","2008_04_WAS_DAL",2008-09-28,"DAL","WAS",24,26,-2,"2008"
"2282","2008_05_ATL_GB",2008-10-05,"GB","ATL",24,27,-3,"2008"
"2283","2008_05_BUF_ARI",2008-10-05,"ARI","BUF",41,17,24,"2008"
"2284","2008_05_CHI_DET",2008-10-05,"DET","CHI",7,34,-27,"2008"
"2285","2008_05_CIN_DAL",2008-10-05,"DAL","CIN",31,22,9,"2008"
"2286","2008_05_IND_HOU",2008-10-05,"HOU","IND",27,31,-4,"2008"
"2287","2008_05_KC_CAR",2008-10-05,"CAR","KC",34,0,34,"2008"
"2288","2008_05_MIN_NO",2008-10-06,"NO","MIN",27,30,-3,"2008"
"2289","2008_05_NE_SF",2008-10-05,"SF","NE",21,30,-9,"2008"
"2290","2008_05_PIT_JAX",2008-10-05,"JAX","PIT",21,26,-5,"2008"
"2291","2008_05_SD_MIA",2008-10-05,"MIA","LAC",17,10,7,"2008"
"2292","2008_05_SEA_NYG",2008-10-05,"NYG","SEA",44,6,38,"2008"
"2293","2008_05_TB_DEN",2008-10-05,"DEN","TB",16,13,3,"2008"
"2294","2008_05_TEN_BAL",2008-10-05,"BAL","TEN",10,13,-3,"2008"
"2295","2008_05_WAS_PHI",2008-10-05,"PHI","WAS",17,23,-6,"2008"
"2296","2008_06_BAL_IND",2008-10-12,"IND","BAL",31,3,28,"2008"
"2297","2008_06_CAR_TB",2008-10-12,"TB","CAR",27,3,24,"2008"
"2298","2008_06_CHI_ATL",2008-10-12,"ATL","CHI",22,20,2,"2008"
"2299","2008_06_CIN_NYJ",2008-10-12,"NYJ","CIN",26,14,12,"2008"
"2300","2008_06_DAL_ARI",2008-10-12,"ARI","DAL",30,24,6,"2008"
"2301","2008_06_DET_MIN",2008-10-12,"MIN","DET",12,10,2,"2008"
"2302","2008_06_GB_SEA",2008-10-12,"SEA","GB",17,27,-10,"2008"
"2303","2008_06_JAX_DEN",2008-10-12,"DEN","JAX",17,24,-7,"2008"
"2304","2008_06_MIA_HOU",2008-10-12,"HOU","MIA",29,28,1,"2008"
"2305","2008_06_NE_SD",2008-10-12,"LAC","NE",30,10,20,"2008"
"2306","2008_06_NYG_CLE",2008-10-13,"CLE","NYG",35,14,21,"2008"
"2307","2008_06_OAK_NO",2008-10-12,"NO","LV",34,3,31,"2008"
"2308","2008_06_PHI_SF",2008-10-12,"SF","PHI",26,40,-14,"2008"
"2309","2008_06_STL_WAS",2008-10-12,"WAS","LA",17,19,-2,"2008"
"2310","2008_07_BAL_MIA",2008-10-19,"MIA","BAL",13,27,-14,"2008"
"2311","2008_07_CLE_WAS",2008-10-19,"WAS","CLE",14,11,3,"2008"
"2312","2008_07_DAL_STL",2008-10-19,"LA","DAL",34,14,20,"2008"
"2313","2008_07_DEN_NE",2008-10-20,"NE","DEN",41,7,34,"2008"
"2314","2008_07_DET_HOU",2008-10-19,"HOU","DET",28,21,7,"2008"
"2315","2008_07_IND_GB",2008-10-19,"GB","IND",34,14,20,"2008"
"2316","2008_07_MIN_CHI",2008-10-19,"CHI","MIN",48,41,7,"2008"
"2317","2008_07_NO_CAR",2008-10-19,"CAR","NO",30,7,23,"2008"
"2318","2008_07_NYJ_OAK",2008-10-19,"LV","NYJ",16,13,3,"2008"
"2319","2008_07_PIT_CIN",2008-10-19,"CIN","PIT",10,38,-28,"2008"
"2320","2008_07_SD_BUF",2008-10-19,"BUF","LAC",23,14,9,"2008"
"2321","2008_07_SEA_TB",2008-10-19,"TB","SEA",20,10,10,"2008"
"2322","2008_07_SF_NYG",2008-10-19,"NYG","SF",29,17,12,"2008"
"2323","2008_07_TEN_KC",2008-10-19,"KC","TEN",10,34,-24,"2008"
"2324","2008_08_ARI_CAR",2008-10-26,"CAR","ARI",27,23,4,"2008"
"2325","2008_08_ATL_PHI",2008-10-26,"PHI","ATL",27,14,13,"2008"
"2326","2008_08_BUF_MIA",2008-10-26,"MIA","BUF",25,16,9,"2008"
"2327","2008_08_CIN_HOU",2008-10-26,"HOU","CIN",35,6,29,"2008"
"2328","2008_08_CLE_JAX",2008-10-26,"JAX","CLE",17,23,-6,"2008"
"2329","2008_08_IND_TEN",2008-10-27,"TEN","IND",31,21,10,"2008"
"2330","2008_08_KC_NYJ",2008-10-26,"NYJ","KC",28,24,4,"2008"
"2331","2008_08_NYG_PIT",2008-10-26,"PIT","NYG",14,21,-7,"2008"
"2332","2008_08_OAK_BAL",2008-10-26,"BAL","LV",29,10,19,"2008"
"2333","2008_08_SD_NO",2008-10-26,"NO","LAC",37,32,5,"2008"
"2334","2008_08_SEA_SF",2008-10-26,"SF","SEA",13,34,-21,"2008"
"2335","2008_08_STL_NE",2008-10-26,"NE","LA",23,16,7,"2008"
"2336","2008_08_TB_DAL",2008-10-26,"DAL","TB",13,9,4,"2008"
"2337","2008_08_WAS_DET",2008-10-26,"DET","WAS",17,25,-8,"2008"
"2338","2008_09_ARI_STL",2008-11-02,"LA","ARI",13,34,-21,"2008"
"2339","2008_09_ATL_OAK",2008-11-02,"LV","ATL",0,24,-24,"2008"
"2340","2008_09_BAL_CLE",2008-11-02,"CLE","BAL",27,37,-10,"2008"
"2341","2008_09_DAL_NYG",2008-11-02,"NYG","DAL",35,14,21,"2008"
"2342","2008_09_DET_CHI",2008-11-02,"CHI","DET",27,23,4,"2008"
"2343","2008_09_GB_TEN",2008-11-02,"TEN","GB",19,16,3,"2008"
"2344","2008_09_HOU_MIN",2008-11-02,"MIN","HOU",28,21,7,"2008"
"2345","2008_09_JAX_CIN",2008-11-02,"CIN","JAX",21,19,2,"2008"
"2346","2008_09_MIA_DEN",2008-11-02,"DEN","MIA",17,26,-9,"2008"
"2347","2008_09_NE_IND",2008-11-02,"IND","NE",18,15,3,"2008"
"2348","2008_09_NYJ_BUF",2008-11-02,"BUF","NYJ",17,26,-9,"2008"
"2349","2008_09_PHI_SEA",2008-11-02,"SEA","PHI",7,26,-19,"2008"
"2350","2008_09_PIT_WAS",2008-11-03,"WAS","PIT",6,23,-17,"2008"
"2351","2008_09_TB_KC",2008-11-02,"KC","TB",27,30,-3,"2008"
"2352","2008_10_BAL_HOU",2008-11-09,"HOU","BAL",13,41,-28,"2008"
"2353","2008_10_BUF_NE",2008-11-09,"NE","BUF",20,10,10,"2008"
"2354","2008_10_CAR_OAK",2008-11-09,"LV","CAR",6,17,-11,"2008"
"2355","2008_10_DEN_CLE",2008-11-06,"CLE","DEN",30,34,-4,"2008"
"2356","2008_10_GB_MIN",2008-11-09,"MIN","GB",28,27,1,"2008"
"2357","2008_10_IND_PIT",2008-11-09,"PIT","IND",20,24,-4,"2008"
"2358","2008_10_JAX_DET",2008-11-09,"DET","JAX",14,38,-24,"2008"
"2359","2008_10_KC_SD",2008-11-09,"LAC","KC",20,19,1,"2008"
"2360","2008_10_NO_ATL",2008-11-09,"ATL","NO",34,20,14,"2008"
"2361","2008_10_NYG_PHI",2008-11-09,"PHI","NYG",31,36,-5,"2008"
"2362","2008_10_SEA_MIA",2008-11-09,"MIA","SEA",21,19,2,"2008"
"2363","2008_10_SF_ARI",2008-11-10,"ARI","SF",29,24,5,"2008"
"2364","2008_10_STL_NYJ",2008-11-09,"NYJ","LA",47,3,44,"2008"
"2365","2008_10_TEN_CHI",2008-11-09,"CHI","TEN",14,21,-7,"2008"
"2366","2008_11_ARI_SEA",2008-11-16,"SEA","ARI",20,26,-6,"2008"
"2367","2008_11_BAL_NYG",2008-11-16,"NYG","BAL",30,10,20,"2008"
"2368","2008_11_CHI_GB",2008-11-16,"GB","CHI",37,3,34,"2008"
"2369","2008_11_CLE_BUF",2008-11-17,"BUF","CLE",27,29,-2,"2008"
"2370","2008_11_DAL_WAS",2008-11-16,"WAS","DAL",10,14,-4,"2008"
"2371","2008_11_DEN_ATL",2008-11-16,"ATL","DEN",20,24,-4,"2008"
"2372","2008_11_DET_CAR",2008-11-16,"CAR","DET",31,22,9,"2008"
"2373","2008_11_HOU_IND",2008-11-16,"IND","HOU",33,27,6,"2008"
"2374","2008_11_MIN_TB",2008-11-16,"TB","MIN",19,13,6,"2008"
"2375","2008_11_NO_KC",2008-11-16,"KC","NO",20,30,-10,"2008"
"2376","2008_11_NYJ_NE",2008-11-13,"NE","NYJ",31,34,-3,"2008"
"2377","2008_11_OAK_MIA",2008-11-16,"MIA","LV",17,15,2,"2008"
"2378","2008_11_PHI_CIN",2008-11-16,"CIN","PHI",13,13,0,"2008"
"2379","2008_11_SD_PIT",2008-11-16,"PIT","LAC",11,10,1,"2008"
"2380","2008_11_STL_SF",2008-11-16,"SF","LA",35,16,19,"2008"
"2381","2008_11_TEN_JAX",2008-11-16,"JAX","TEN",14,24,-10,"2008"
"2382","2008_12_BUF_KC",2008-11-23,"KC","BUF",31,54,-23,"2008"
"2383","2008_12_CAR_ATL",2008-11-23,"ATL","CAR",45,28,17,"2008"
"2384","2008_12_CHI_STL",2008-11-23,"LA","CHI",3,27,-24,"2008"
"2385","2008_12_CIN_PIT",2008-11-20,"PIT","CIN",27,10,17,"2008"
"2386","2008_12_GB_NO",2008-11-24,"NO","GB",51,29,22,"2008"
"2387","2008_12_HOU_CLE",2008-11-23,"CLE","HOU",6,16,-10,"2008"
"2388","2008_12_IND_SD",2008-11-23,"LAC","IND",20,23,-3,"2008"
"2389","2008_12_MIN_JAX",2008-11-23,"JAX","MIN",12,30,-18,"2008"
"2390","2008_12_NE_MIA",2008-11-23,"MIA","NE",28,48,-20,"2008"
"2391","2008_12_NYG_ARI",2008-11-23,"ARI","NYG",29,37,-8,"2008"
"2392","2008_12_NYJ_TEN",2008-11-23,"TEN","NYJ",13,34,-21,"2008"
"2393","2008_12_OAK_DEN",2008-11-23,"DEN","LV",10,31,-21,"2008"
"2394","2008_12_PHI_BAL",2008-11-23,"BAL","PHI",36,7,29,"2008"
"2395","2008_12_SF_DAL",2008-11-23,"DAL","SF",35,22,13,"2008"
"2396","2008_12_TB_DET",2008-11-23,"DET","TB",20,38,-18,"2008"
"2397","2008_12_WAS_SEA",2008-11-23,"SEA","WAS",17,20,-3,"2008"
"2398","2008_13_ARI_PHI",2008-11-27,"PHI","ARI",48,20,28,"2008"
"2399","2008_13_ATL_SD",2008-11-30,"LAC","ATL",16,22,-6,"2008"
"2400","2008_13_BAL_CIN",2008-11-30,"CIN","BAL",3,34,-31,"2008"
"2401","2008_13_CAR_GB",2008-11-30,"GB","CAR",31,35,-4,"2008"
"2402","2008_13_CHI_MIN",2008-11-30,"MIN","CHI",34,14,20,"2008"
"2403","2008_13_DEN_NYJ",2008-11-30,"NYJ","DEN",17,34,-17,"2008"
"2404","2008_13_IND_CLE",2008-11-30,"CLE","IND",6,10,-4,"2008"
"2405","2008_13_JAX_HOU",2008-12-01,"HOU","JAX",30,17,13,"2008"
"2406","2008_13_KC_OAK",2008-11-30,"LV","KC",13,20,-7,"2008"
"2407","2008_13_MIA_STL",2008-11-30,"LA","MIA",12,16,-4,"2008"
"2408","2008_13_NO_TB",2008-11-30,"TB","NO",23,20,3,"2008"
"2409","2008_13_NYG_WAS",2008-11-30,"WAS","NYG",7,23,-16,"2008"
"2410","2008_13_PIT_NE",2008-11-30,"NE","PIT",10,33,-23,"2008"
"2411","2008_13_SEA_DAL",2008-11-27,"DAL","SEA",34,9,25,"2008"
"2412","2008_13_SF_BUF",2008-11-30,"BUF","SF",3,10,-7,"2008"
"2413","2008_13_TEN_DET",2008-11-27,"DET","TEN",10,47,-37,"2008"
"2414","2008_14_ATL_NO",2008-12-07,"NO","ATL",29,25,4,"2008"
"2415","2008_14_CIN_IND",2008-12-07,"IND","CIN",35,3,32,"2008"
"2416","2008_14_CLE_TEN",2008-12-07,"TEN","CLE",28,9,19,"2008"
"2417","2008_14_DAL_PIT",2008-12-07,"PIT","DAL",20,13,7,"2008"
"2418","2008_14_HOU_GB",2008-12-07,"GB","HOU",21,24,-3,"2008"
"2419","2008_14_JAX_CHI",2008-12-07,"CHI","JAX",23,10,13,"2008"
"2420","2008_14_KC_DEN",2008-12-07,"DEN","KC",24,17,7,"2008"
"2421","2008_14_MIA_BUF",2008-12-07,"BUF","MIA",3,16,-13,"2008"
"2422","2008_14_MIN_DET",2008-12-07,"DET","MIN",16,20,-4,"2008"
"2423","2008_14_NE_SEA",2008-12-07,"SEA","NE",21,24,-3,"2008"
"2424","2008_14_NYJ_SF",2008-12-07,"SF","NYJ",24,14,10,"2008"
"2425","2008_14_OAK_SD",2008-12-04,"LAC","LV",34,7,27,"2008"
"2426","2008_14_PHI_NYG",2008-12-07,"NYG","PHI",14,20,-6,"2008"
"2427","2008_14_STL_ARI",2008-12-07,"ARI","LA",34,10,24,"2008"
"2428","2008_14_TB_CAR",2008-12-08,"CAR","TB",38,23,15,"2008"
"2429","2008_14_WAS_BAL",2008-12-07,"BAL","WAS",24,10,14,"2008"
"2430","2008_15_BUF_NYJ",2008-12-14,"NYJ","BUF",31,27,4,"2008"
"2431","2008_15_CLE_PHI",2008-12-15,"PHI","CLE",30,10,20,"2008"
"2432","2008_15_DEN_CAR",2008-12-14,"CAR","DEN",30,10,20,"2008"
"2433","2008_15_DET_IND",2008-12-14,"IND","DET",31,21,10,"2008"
"2434","2008_15_GB_JAX",2008-12-14,"JAX","GB",20,16,4,"2008"
"2435","2008_15_MIN_ARI",2008-12-14,"ARI","MIN",14,35,-21,"2008"
"2436","2008_15_NE_OAK",2008-12-14,"LV","NE",26,49,-23,"2008"
"2437","2008_15_NO_CHI",2008-12-11,"CHI","NO",27,24,3,"2008"
"2438","2008_15_NYG_DAL",2008-12-14,"DAL","NYG",20,8,12,"2008"
"2439","2008_15_PIT_BAL",2008-12-14,"BAL","PIT",9,13,-4,"2008"
"2440","2008_15_SD_KC",2008-12-14,"KC","LAC",21,22,-1,"2008"
"2441","2008_15_SEA_STL",2008-12-14,"LA","SEA",20,23,-3,"2008"
"2442","2008_15_SF_MIA",2008-12-14,"MIA","SF",14,9,5,"2008"
"2443","2008_15_TB_ATL",2008-12-14,"ATL","TB",13,10,3,"2008"
"2444","2008_15_TEN_HOU",2008-12-14,"HOU","TEN",13,12,1,"2008"
"2445","2008_15_WAS_CIN",2008-12-14,"CIN","WAS",20,13,7,"2008"
"2446","2008_16_ARI_NE",2008-12-21,"NE","ARI",47,7,40,"2008"
"2447","2008_16_ATL_MIN",2008-12-21,"MIN","ATL",17,24,-7,"2008"
"2448","2008_16_BAL_DAL",2008-12-20,"DAL","BAL",24,33,-9,"2008"
"2449","2008_16_BUF_DEN",2008-12-21,"DEN","BUF",23,30,-7,"2008"
"2450","2008_16_CAR_NYG",2008-12-21,"NYG","CAR",34,28,6,"2008"
"2451","2008_16_CIN_CLE",2008-12-21,"CLE","CIN",0,14,-14,"2008"
"2452","2008_16_GB_CHI",2008-12-22,"CHI","GB",20,17,3,"2008"
"2453","2008_16_HOU_OAK",2008-12-21,"LV","HOU",27,16,11,"2008"
"2454","2008_16_IND_JAX",2008-12-18,"JAX","IND",24,31,-7,"2008"
"2455","2008_16_MIA_KC",2008-12-21,"KC","MIA",31,38,-7,"2008"
"2456","2008_16_NO_DET",2008-12-21,"DET","NO",7,42,-35,"2008"
"2457","2008_16_NYJ_SEA",2008-12-21,"SEA","NYJ",13,3,10,"2008"
"2458","2008_16_PHI_WAS",2008-12-21,"WAS","PHI",10,3,7,"2008"
"2459","2008_16_PIT_TEN",2008-12-21,"TEN","PIT",31,14,17,"2008"
"2460","2008_16_SD_TB",2008-12-21,"TB","LAC",24,41,-17,"2008"
"2461","2008_16_SF_STL",2008-12-21,"LA","SF",16,17,-1,"2008"
"2462","2008_17_CAR_NO",2008-12-28,"NO","CAR",31,33,-2,"2008"
"2463","2008_17_CHI_HOU",2008-12-28,"HOU","CHI",31,24,7,"2008"
"2464","2008_17_CLE_PIT",2008-12-28,"PIT","CLE",31,0,31,"2008"
"2465","2008_17_DAL_PHI",2008-12-28,"PHI","DAL",44,6,38,"2008"
"2466","2008_17_DEN_SD",2008-12-28,"LAC","DEN",52,21,31,"2008"
"2467","2008_17_DET_GB",2008-12-28,"GB","DET",31,21,10,"2008"
"2468","2008_17_JAX_BAL",2008-12-28,"BAL","JAX",27,7,20,"2008"
"2469","2008_17_KC_CIN",2008-12-28,"CIN","KC",16,6,10,"2008"
"2470","2008_17_MIA_NYJ",2008-12-28,"NYJ","MIA",17,24,-7,"2008"
"2471","2008_17_NE_BUF",2008-12-28,"BUF","NE",0,13,-13,"2008"
"2472","2008_17_NYG_MIN",2008-12-28,"MIN","NYG",20,19,1,"2008"
"2473","2008_17_OAK_TB",2008-12-28,"TB","LV",24,31,-7,"2008"
"2474","2008_17_SEA_ARI",2008-12-28,"ARI","SEA",34,21,13,"2008"
"2475","2008_17_STL_ATL",2008-12-28,"ATL","LA",31,27,4,"2008"
"2476","2008_17_TEN_IND",2008-12-28,"IND","TEN",23,0,23,"2008"
"2477","2008_17_WAS_SF",2008-12-28,"SF","WAS",27,24,3,"2008"
"2478","2009_01_BUF_NE",2009-09-14,"NE","BUF",25,24,1,"2009"
"2479","2009_01_CHI_GB",2009-09-13,"GB","CHI",21,15,6,"2009"
"2480","2009_01_DAL_TB",2009-09-13,"TB","DAL",21,34,-13,"2009"
"2481","2009_01_DEN_CIN",2009-09-13,"CIN","DEN",7,12,-5,"2009"
"2482","2009_01_DET_NO",2009-09-13,"NO","DET",45,27,18,"2009"
"2483","2009_01_JAX_IND",2009-09-13,"IND","JAX",14,12,2,"2009"
"2484","2009_01_KC_BAL",2009-09-13,"BAL","KC",38,24,14,"2009"
"2485","2009_01_MIA_ATL",2009-09-13,"ATL","MIA",19,7,12,"2009"
"2486","2009_01_MIN_CLE",2009-09-13,"CLE","MIN",20,34,-14,"2009"
"2487","2009_01_NYJ_HOU",2009-09-13,"HOU","NYJ",7,24,-17,"2009"
"2488","2009_01_PHI_CAR",2009-09-13,"CAR","PHI",10,38,-28,"2009"
"2489","2009_01_SD_OAK",2009-09-14,"LV","LAC",20,24,-4,"2009"
"2490","2009_01_SF_ARI",2009-09-13,"ARI","SF",16,20,-4,"2009"
"2491","2009_01_STL_SEA",2009-09-13,"SEA","LA",28,0,28,"2009"
"2492","2009_01_TEN_PIT",2009-09-10,"PIT","TEN",13,10,3,"2009"
"2493","2009_01_WAS_NYG",2009-09-13,"NYG","WAS",23,17,6,"2009"
"2494","2009_02_ARI_JAX",2009-09-20,"JAX","ARI",17,31,-14,"2009"
"2495","2009_02_BAL_SD",2009-09-20,"LAC","BAL",26,31,-5,"2009"
"2496","2009_02_CAR_ATL",2009-09-20,"ATL","CAR",28,20,8,"2009"
"2497","2009_02_CIN_GB",2009-09-20,"GB","CIN",24,31,-7,"2009"
"2498","2009_02_CLE_DEN",2009-09-20,"DEN","CLE",27,6,21,"2009"
"2499","2009_02_HOU_TEN",2009-09-20,"TEN","HOU",31,34,-3,"2009"
"2500","2009_02_IND_MIA",2009-09-21,"MIA","IND",23,27,-4,"2009"
"2501","2009_02_MIN_DET",2009-09-20,"DET","MIN",13,27,-14,"2009"
"2502","2009_02_NE_NYJ",2009-09-20,"NYJ","NE",16,9,7,"2009"
"2503","2009_02_NO_PHI",2009-09-20,"PHI","NO",22,48,-26,"2009"
"2504","2009_02_NYG_DAL",2009-09-20,"DAL","NYG",31,33,-2,"2009"
"2505","2009_02_OAK_KC",2009-09-20,"KC","LV",10,13,-3,"2009"
"2506","2009_02_PIT_CHI",2009-09-20,"CHI","PIT",17,14,3,"2009"
"2507","2009_02_SEA_SF",2009-09-20,"SF","SEA",23,10,13,"2009"
"2508","2009_02_STL_WAS",2009-09-20,"WAS","LA",9,7,2,"2009"
"2509","2009_02_TB_BUF",2009-09-20,"BUF","TB",33,20,13,"2009"
"2510","2009_03_ATL_NE",2009-09-27,"NE","ATL",26,10,16,"2009"
"2511","2009_03_CAR_DAL",2009-09-28,"DAL","CAR",21,7,14,"2009"
"2512","2009_03_CHI_SEA",2009-09-27,"SEA","CHI",19,25,-6,"2009"
"2513","2009_03_CLE_BAL",2009-09-27,"BAL","CLE",34,3,31,"2009"
"2514","2009_03_DEN_OAK",2009-09-27,"LV","DEN",3,23,-20,"2009"
"2515","2009_03_GB_STL",2009-09-27,"LA","GB",17,36,-19,"2009"
"2516","2009_03_IND_ARI",2009-09-27,"ARI","IND",10,31,-21,"2009"
"2517","2009_03_JAX_HOU",2009-09-27,"HOU","JAX",24,31,-7,"2009"
"2518","2009_03_KC_PHI",2009-09-27,"PHI","KC",34,14,20,"2009"
"2519","2009_03_MIA_SD",2009-09-27,"LAC","MIA",23,13,10,"2009"
"2520","2009_03_NO_BUF",2009-09-27,"BUF","NO",7,27,-20,"2009"
"2521","2009_03_NYG_TB",2009-09-27,"TB","NYG",0,24,-24,"2009"
"2522","2009_03_PIT_CIN",2009-09-27,"CIN","PIT",23,20,3,"2009"
"2523","2009_03_SF_MIN",2009-09-27,"MIN","SF",27,24,3,"2009"
"2524","2009_03_TEN_NYJ",2009-09-27,"NYJ","TEN",24,17,7,"2009"
"2525","2009_03_WAS_DET",2009-09-27,"DET","WAS",19,14,5,"2009"
"2526","2009_04_BAL_NE",2009-10-04,"NE","BAL",27,21,6,"2009"
"2527","2009_04_BUF_MIA",2009-10-04,"MIA","BUF",38,10,28,"2009"
"2528","2009_04_CIN_CLE",2009-10-04,"CLE","CIN",20,23,-3,"2009"
"2529","2009_04_DAL_DEN",2009-10-04,"DEN","DAL",17,10,7,"2009"
"2530","2009_04_DET_CHI",2009-10-04,"CHI","DET",48,24,24,"2009"
"2531","2009_04_GB_MIN",2009-10-05,"MIN","GB",30,23,7,"2009"
"2532","2009_04_NYG_KC",2009-10-04,"KC","NYG",16,27,-11,"2009"
"2533","2009_04_NYJ_NO",2009-10-04,"NO","NYJ",24,10,14,"2009"
"2534","2009_04_OAK_HOU",2009-10-04,"HOU","LV",29,6,23,"2009"
"2535","2009_04_SD_PIT",2009-10-04,"PIT","LAC",38,28,10,"2009"
"2536","2009_04_SEA_IND",2009-10-04,"IND","SEA",34,17,17,"2009"
"2537","2009_04_STL_SF",2009-10-04,"SF","LA",35,0,35,"2009"
"2538","2009_04_TB_WAS",2009-10-04,"WAS","TB",16,13,3,"2009"
"2539","2009_04_TEN_JAX",2009-10-04,"JAX","TEN",37,17,20,"2009"
"2540","2009_05_ATL_SF",2009-10-11,"SF","ATL",10,45,-35,"2009"
"2541","2009_05_CIN_BAL",2009-10-11,"BAL","CIN",14,17,-3,"2009"
"2542","2009_05_CLE_BUF",2009-10-11,"BUF","CLE",3,6,-3,"2009"
"2543","2009_05_DAL_KC",2009-10-11,"KC","DAL",20,26,-6,"2009"
"2544","2009_05_HOU_ARI",2009-10-11,"ARI","HOU",28,21,7,"2009"
"2545","2009_05_IND_TEN",2009-10-11,"TEN","IND",9,31,-22,"2009"
"2546","2009_05_JAX_SEA",2009-10-11,"SEA","JAX",41,0,41,"2009"
"2547","2009_05_MIN_STL",2009-10-11,"LA","MIN",10,38,-28,"2009"
"2548","2009_05_NE_DEN",2009-10-11,"DEN","NE",20,17,3,"2009"
"2549","2009_05_NYJ_MIA",2009-10-12,"MIA","NYJ",31,27,4,"2009"
"2550","2009_05_OAK_NYG",2009-10-11,"NYG","LV",44,7,37,"2009"
"2551","2009_05_PIT_DET",2009-10-11,"DET","PIT",20,28,-8,"2009"
"2552","2009_05_TB_PHI",2009-10-11,"PHI","TB",33,14,19,"2009"
"2553","2009_05_WAS_CAR",2009-10-11,"CAR","WAS",20,17,3,"2009"
"2554","2009_06_ARI_SEA",2009-10-18,"SEA","ARI",3,27,-24,"2009"
"2555","2009_06_BAL_MIN",2009-10-18,"MIN","BAL",33,31,2,"2009"
"2556","2009_06_BUF_NYJ",2009-10-18,"NYJ","BUF",13,16,-3,"2009"
"2557","2009_06_CAR_TB",2009-10-18,"TB","CAR",21,28,-7,"2009"
"2558","2009_06_CHI_ATL",2009-10-18,"ATL","CHI",21,14,7,"2009"
"2559","2009_06_CLE_PIT",2009-10-18,"PIT","CLE",27,14,13,"2009"
"2560","2009_06_DEN_SD",2009-10-19,"LAC","DEN",23,34,-11,"2009"
"2561","2009_06_DET_GB",2009-10-18,"GB","DET",26,0,26,"2009"
"2562","2009_06_HOU_CIN",2009-10-18,"CIN","HOU",17,28,-11,"2009"
"2563","2009_06_KC_WAS",2009-10-18,"WAS","KC",6,14,-8,"2009"
"2564","2009_06_NYG_NO",2009-10-18,"NO","NYG",48,27,21,"2009"
"2565","2009_06_PHI_OAK",2009-10-18,"LV","PHI",13,9,4,"2009"
"2566","2009_06_STL_JAX",2009-10-18,"JAX","LA",23,20,3,"2009"
"2567","2009_06_TEN_NE",2009-10-18,"NE","TEN",59,0,59,"2009"
"2568","2009_07_ARI_NYG",2009-10-25,"NYG","ARI",17,24,-7,"2009"
"2569","2009_07_ATL_DAL",2009-10-25,"DAL","ATL",37,21,16,"2009"
"2570","2009_07_BUF_CAR",2009-10-25,"CAR","BUF",9,20,-11,"2009"
"2571","2009_07_CHI_CIN",2009-10-25,"CIN","CHI",45,10,35,"2009"
"2572","2009_07_GB_CLE",2009-10-25,"CLE","GB",3,31,-28,"2009"
"2573","2009_07_IND_STL",2009-10-25,"LA","IND",6,42,-36,"2009"
"2574","2009_07_MIN_PIT",2009-10-25,"PIT","MIN",27,17,10,"2009"
"2575","2009_07_NE_TB",2009-10-25,"TB","NE",7,35,-28,"2009"
"2576","2009_07_NO_MIA",2009-10-25,"MIA","NO",34,46,-12,"2009"
"2577","2009_07_NYJ_OAK",2009-10-25,"LV","NYJ",0,38,-38,"2009"
"2578","2009_07_PHI_WAS",2009-10-26,"WAS","PHI",17,27,-10,"2009"
"2579","2009_07_SD_KC",2009-10-25,"KC","LAC",7,37,-30,"2009"
"2580","2009_07_SF_HOU",2009-10-25,"HOU","SF",24,21,3,"2009"
"2581","2009_08_ATL_NO",2009-11-02,"NO","ATL",35,27,8,"2009"
"2582","2009_08_CAR_ARI",2009-11-01,"ARI","CAR",21,34,-13,"2009"
"2583","2009_08_CLE_CHI",2009-11-01,"CHI","CLE",30,6,24,"2009"
"2584","2009_08_DEN_BAL",2009-11-01,"BAL","DEN",30,7,23,"2009"
"2585","2009_08_HOU_BUF",2009-11-01,"BUF","HOU",10,31,-21,"2009"
"2586","2009_08_JAX_TEN",2009-11-01,"TEN","JAX",30,13,17,"2009"
"2587","2009_08_MIA_NYJ",2009-11-01,"NYJ","MIA",25,30,-5,"2009"
"2588","2009_08_MIN_GB",2009-11-01,"GB","MIN",26,38,-12,"2009"
"2589","2009_08_NYG_PHI",2009-11-01,"PHI","NYG",40,17,23,"2009"
"2590","2009_08_OAK_SD",2009-11-01,"LAC","LV",24,16,8,"2009"
"2591","2009_08_SEA_DAL",2009-11-01,"DAL","SEA",38,17,21,"2009"
"2592","2009_08_SF_IND",2009-11-01,"IND","SF",18,14,4,"2009"
"2593","2009_08_STL_DET",2009-11-01,"DET","LA",10,17,-7,"2009"
"2594","2009_09_ARI_CHI",2009-11-08,"CHI","ARI",21,41,-20,"2009"
"2595","2009_09_BAL_CIN",2009-11-08,"CIN","BAL",17,7,10,"2009"
"2596","2009_09_CAR_NO",2009-11-08,"NO","CAR",30,20,10,"2009"
"2597","2009_09_DAL_PHI",2009-11-08,"PHI","DAL",16,20,-4,"2009"
"2598","2009_09_DET_SEA",2009-11-08,"SEA","DET",32,20,12,"2009"
"2599","2009_09_GB_TB",2009-11-08,"TB","GB",38,28,10,"2009"
"2600","2009_09_HOU_IND",2009-11-08,"IND","HOU",20,17,3,"2009"
"2601","2009_09_KC_JAX",2009-11-08,"JAX","KC",24,21,3,"2009"
"2602","2009_09_MIA_NE",2009-11-08,"NE","MIA",27,17,10,"2009"
"2603","2009_09_PIT_DEN",2009-11-09,"DEN","PIT",10,28,-18,"2009"
"2604","2009_09_SD_NYG",2009-11-08,"NYG","LAC",20,21,-1,"2009"
"2605","2009_09_TEN_SF",2009-11-08,"SF","TEN",27,34,-7,"2009"
"2606","2009_09_WAS_ATL",2009-11-08,"ATL","WAS",31,17,14,"2009"
"2607","2009_10_ATL_CAR",2009-11-15,"CAR","ATL",28,19,9,"2009"
"2608","2009_10_BAL_CLE",2009-11-16,"CLE","BAL",0,16,-16,"2009"
"2609","2009_10_BUF_TEN",2009-11-15,"TEN","BUF",41,17,24,"2009"
"2610","2009_10_CHI_SF",2009-11-12,"SF","CHI",10,6,4,"2009"
"2611","2009_10_CIN_PIT",2009-11-15,"PIT","CIN",12,18,-6,"2009"
"2612","2009_10_DAL_GB",2009-11-15,"GB","DAL",17,7,10,"2009"
"2613","2009_10_DEN_WAS",2009-11-15,"WAS","DEN",27,17,10,"2009"
"2614","2009_10_DET_MIN",2009-11-15,"MIN","DET",27,10,17,"2009"
"2615","2009_10_JAX_NYJ",2009-11-15,"NYJ","JAX",22,24,-2,"2009"
"2616","2009_10_KC_OAK",2009-11-15,"LV","KC",10,16,-6,"2009"
"2617","2009_10_NE_IND",2009-11-15,"IND","NE",35,34,1,"2009"
"2618","2009_10_NO_STL",2009-11-15,"LA","NO",23,28,-5,"2009"
"2619","2009_10_PHI_SD",2009-11-15,"LAC","PHI",31,23,8,"2009"
"2620","2009_10_SEA_ARI",2009-11-15,"ARI","SEA",31,20,11,"2009"
"2621","2009_10_TB_MIA",2009-11-15,"MIA","TB",25,23,2,"2009"
"2622","2009_11_ARI_STL",2009-11-22,"LA","ARI",13,21,-8,"2009"
"2623","2009_11_ATL_NYG",2009-11-22,"NYG","ATL",34,31,3,"2009"
"2624","2009_11_BUF_JAX",2009-11-22,"JAX","BUF",18,15,3,"2009"
"2625","2009_11_CIN_OAK",2009-11-22,"LV","CIN",20,17,3,"2009"
"2626","2009_11_CLE_DET",2009-11-22,"DET","CLE",38,37,1,"2009"
"2627","2009_11_IND_BAL",2009-11-22,"BAL","IND",15,17,-2,"2009"
"2628","2009_11_MIA_CAR",2009-11-19,"CAR","MIA",17,24,-7,"2009"
"2629","2009_11_NO_TB",2009-11-22,"TB","NO",7,38,-31,"2009"
"2630","2009_11_NYJ_NE",2009-11-22,"NE","NYJ",31,14,17,"2009"
"2631","2009_11_PHI_CHI",2009-11-22,"CHI","PHI",20,24,-4,"2009"
"2632","2009_11_PIT_KC",2009-11-22,"KC","PIT",27,24,3,"2009"
"2633","2009_11_SD_DEN",2009-11-22,"DEN","LAC",3,32,-29,"2009"
"2634","2009_11_SEA_MIN",2009-11-22,"MIN","SEA",35,9,26,"2009"
"2635","2009_11_SF_GB",2009-11-22,"GB","SF",30,24,6,"2009"
"2636","2009_11_TEN_HOU",2009-11-23,"HOU","TEN",17,20,-3,"2009"
"2637","2009_11_WAS_DAL",2009-11-22,"DAL","WAS",7,6,1,"2009"
"2638","2009_12_ARI_TEN",2009-11-29,"TEN","ARI",20,17,3,"2009"
"2639","2009_12_CAR_NYJ",2009-11-29,"NYJ","CAR",17,6,11,"2009"
"2640","2009_12_CHI_MIN",2009-11-29,"MIN","CHI",36,10,26,"2009"
"2641","2009_12_CLE_CIN",2009-11-29,"CIN","CLE",16,7,9,"2009"
"2642","2009_12_GB_DET",2009-11-26,"DET","GB",12,34,-22,"2009"
"2643","2009_12_IND_HOU",2009-11-29,"HOU","IND",27,35,-8,"2009"
"2644","2009_12_JAX_SF",2009-11-29,"SF","JAX",20,3,17,"2009"
"2645","2009_12_KC_SD",2009-11-29,"LAC","KC",43,14,29,"2009"
"2646","2009_12_MIA_BUF",2009-11-29,"BUF","MIA",31,14,17,"2009"
"2647","2009_12_NE_NO",2009-11-30,"NO","NE",38,17,21,"2009"
"2648","2009_12_NYG_DEN",2009-11-26,"DEN","NYG",26,6,20,"2009"
"2649","2009_12_OAK_DAL",2009-11-26,"DAL","LV",24,7,17,"2009"
"2650","2009_12_PIT_BAL",2009-11-29,"BAL","PIT",20,17,3,"2009"
"2651","2009_12_SEA_STL",2009-11-29,"LA","SEA",17,27,-10,"2009"
"2652","2009_12_TB_ATL",2009-11-29,"ATL","TB",20,17,3,"2009"
"2653","2009_12_WAS_PHI",2009-11-29,"PHI","WAS",27,24,3,"2009"
"2654","2009_13_BAL_GB",2009-12-07,"GB","BAL",27,14,13,"2009"
"2655","2009_13_DAL_NYG",2009-12-06,"NYG","DAL",31,24,7,"2009"
"2656","2009_13_DEN_KC",2009-12-06,"KC","DEN",13,44,-31,"2009"
"2657","2009_13_DET_CIN",2009-12-06,"CIN","DET",23,13,10,"2009"
"2658","2009_13_HOU_JAX",2009-12-06,"JAX","HOU",23,18,5,"2009"
"2659","2009_13_MIN_ARI",2009-12-06,"ARI","MIN",30,17,13,"2009"
"2660","2009_13_NE_MIA",2009-12-06,"MIA","NE",22,21,1,"2009"
"2661","2009_13_NO_WAS",2009-12-06,"WAS","NO",30,33,-3,"2009"
"2662","2009_13_NYJ_BUF",2009-12-03,"BUF","NYJ",13,19,-6,"2009"
"2663","2009_13_OAK_PIT",2009-12-06,"PIT","LV",24,27,-3,"2009"
"2664","2009_13_PHI_ATL",2009-12-06,"ATL","PHI",7,34,-27,"2009"
"2665","2009_13_SD_CLE",2009-12-06,"CLE","LAC",23,30,-7,"2009"
"2666","2009_13_SF_SEA",2009-12-06,"SEA","SF",20,17,3,"2009"
"2667","2009_13_STL_CHI",2009-12-06,"CHI","LA",17,9,8,"2009"
"2668","2009_13_TB_CAR",2009-12-06,"CAR","TB",16,6,10,"2009"
"2669","2009_13_TEN_IND",2009-12-06,"IND","TEN",27,17,10,"2009"
"2670","2009_14_ARI_SF",2009-12-14,"SF","ARI",24,9,15,"2009"
"2671","2009_14_BUF_KC",2009-12-13,"KC","BUF",10,16,-6,"2009"
"2672","2009_14_CAR_NE",2009-12-13,"NE","CAR",20,10,10,"2009"
"2673","2009_14_CIN_MIN",2009-12-13,"MIN","CIN",30,10,20,"2009"
"2674","2009_14_DEN_IND",2009-12-13,"IND","DEN",28,16,12,"2009"
"2675","2009_14_DET_BAL",2009-12-13,"BAL","DET",48,3,45,"2009"
"2676","2009_14_GB_CHI",2009-12-13,"CHI","GB",14,21,-7,"2009"
"2677","2009_14_MIA_JAX",2009-12-13,"JAX","MIA",10,14,-4,"2009"
"2678","2009_14_NO_ATL",2009-12-13,"ATL","NO",23,26,-3,"2009"
"2679","2009_14_NYJ_TB",2009-12-13,"TB","NYJ",3,26,-23,"2009"
"2680","2009_14_PHI_NYG",2009-12-13,"NYG","PHI",38,45,-7,"2009"
"2681","2009_14_PIT_CLE",2009-12-10,"CLE","PIT",13,6,7,"2009"
"2682","2009_14_SD_DAL",2009-12-13,"DAL","LAC",17,20,-3,"2009"
"2683","2009_14_SEA_HOU",2009-12-13,"HOU","SEA",34,7,27,"2009"
"2684","2009_14_STL_TEN",2009-12-13,"TEN","LA",47,7,40,"2009"
"2685","2009_14_WAS_OAK",2009-12-13,"LV","WAS",13,34,-21,"2009"
"2686","2009_15_ARI_DET",2009-12-20,"DET","ARI",24,31,-7,"2009"
"2687","2009_15_ATL_NYJ",2009-12-20,"NYJ","ATL",7,10,-3,"2009"
"2688","2009_15_CHI_BAL",2009-12-20,"BAL","CHI",31,7,24,"2009"
"2689","2009_15_CIN_SD",2009-12-20,"LAC","CIN",27,24,3,"2009"
"2690","2009_15_CLE_KC",2009-12-20,"KC","CLE",34,41,-7,"2009"
"2691","2009_15_DAL_NO",2009-12-19,"NO","DAL",17,24,-7,"2009"
"2692","2009_15_GB_PIT",2009-12-20,"PIT","GB",37,36,1,"2009"
"2693","2009_15_HOU_STL",2009-12-20,"LA","HOU",13,16,-3,"2009"
"2694","2009_15_IND_JAX",2009-12-17,"JAX","IND",31,35,-4,"2009"
"2695","2009_15_MIA_TEN",2009-12-20,"TEN","MIA",27,24,3,"2009"
"2696","2009_15_MIN_CAR",2009-12-20,"CAR","MIN",26,7,19,"2009"
"2697","2009_15_NE_BUF",2009-12-20,"BUF","NE",10,17,-7,"2009"
"2698","2009_15_NYG_WAS",2009-12-21,"WAS","NYG",12,45,-33,"2009"
"2699","2009_15_OAK_DEN",2009-12-20,"DEN","LV",19,20,-1,"2009"
"2700","2009_15_SF_PHI",2009-12-20,"PHI","SF",27,13,14,"2009"
"2701","2009_15_TB_SEA",2009-12-20,"SEA","TB",7,24,-17,"2009"
"2702","2009_16_BAL_PIT",2009-12-27,"PIT","BAL",23,20,3,"2009"
"2703","2009_16_BUF_ATL",2009-12-27,"ATL","BUF",31,3,28,"2009"
"2704","2009_16_CAR_NYG",2009-12-27,"NYG","CAR",9,41,-32,"2009"
"2705","2009_16_DAL_WAS",2009-12-27,"WAS","DAL",0,17,-17,"2009"
"2706","2009_16_DEN_PHI",2009-12-27,"PHI","DEN",30,27,3,"2009"
"2707","2009_16_DET_SF",2009-12-27,"SF","DET",20,6,14,"2009"
"2708","2009_16_HOU_MIA",2009-12-27,"MIA","HOU",20,27,-7,"2009"
"2709","2009_16_JAX_NE",2009-12-27,"NE","JAX",35,7,28,"2009"
"2710","2009_16_KC_CIN",2009-12-27,"CIN","KC",17,10,7,"2009"
"2711","2009_16_MIN_CHI",2009-12-28,"CHI","MIN",36,30,6,"2009"
"2712","2009_16_NYJ_IND",2009-12-27,"IND","NYJ",15,29,-14,"2009"
"2713","2009_16_OAK_CLE",2009-12-27,"CLE","LV",23,9,14,"2009"
"2714","2009_16_SD_TEN",2009-12-25,"TEN","LAC",17,42,-25,"2009"
"2715","2009_16_SEA_GB",2009-12-27,"GB","SEA",48,10,38,"2009"
"2716","2009_16_STL_ARI",2009-12-27,"ARI","LA",31,10,21,"2009"
"2717","2009_16_TB_NO",2009-12-27,"NO","TB",17,20,-3,"2009"
"2718","2010_01_ARI_STL",2010-09-12,"LA","ARI",13,17,-4,"2010"
"2719","2010_01_ATL_PIT",2010-09-12,"PIT","ATL",15,9,6,"2010"
"2720","2010_01_BAL_NYJ",2010-09-13,"NYJ","BAL",9,10,-1,"2010"
"2721","2010_01_CAR_NYG",2010-09-12,"NYG","CAR",31,18,13,"2010"
"2722","2010_01_CIN_NE",2010-09-12,"NE","CIN",38,24,14,"2010"
"2723","2010_01_CLE_TB",2010-09-12,"TB","CLE",17,14,3,"2010"
"2724","2010_01_DAL_WAS",2010-09-12,"WAS","DAL",13,7,6,"2010"
"2725","2010_01_DEN_JAX",2010-09-12,"JAX","DEN",24,17,7,"2010"
"2726","2010_01_DET_CHI",2010-09-12,"CHI","DET",19,14,5,"2010"
"2727","2010_01_GB_PHI",2010-09-12,"PHI","GB",20,27,-7,"2010"
"2728","2010_01_IND_HOU",2010-09-12,"HOU","IND",34,24,10,"2010"
"2729","2010_01_MIA_BUF",2010-09-12,"BUF","MIA",10,15,-5,"2010"
"2730","2010_01_MIN_NO",2010-09-09,"NO","MIN",14,9,5,"2010"
"2731","2010_01_OAK_TEN",2010-09-12,"TEN","LV",38,13,25,"2010"
"2732","2010_01_SD_KC",2010-09-13,"KC","LAC",21,14,7,"2010"
"2733","2010_01_SF_SEA",2010-09-12,"SEA","SF",31,6,25,"2010"
"2734","2010_02_ARI_ATL",2010-09-19,"ATL","ARI",41,7,34,"2010"
"2735","2010_02_BAL_CIN",2010-09-19,"CIN","BAL",15,10,5,"2010"
"2736","2010_02_BUF_GB",2010-09-19,"GB","BUF",34,7,27,"2010"
"2737","2010_02_CHI_DAL",2010-09-19,"DAL","CHI",20,27,-7,"2010"
"2738","2010_02_HOU_WAS",2010-09-19,"WAS","HOU",27,30,-3,"2010"
"2739","2010_02_JAX_SD",2010-09-19,"LAC","JAX",38,13,25,"2010"
"2740","2010_02_KC_CLE",2010-09-19,"CLE","KC",14,16,-2,"2010"
"2741","2010_02_MIA_MIN",2010-09-19,"MIN","MIA",10,14,-4,"2010"
"2742","2010_02_NE_NYJ",2010-09-19,"NYJ","NE",28,14,14,"2010"
"2743","2010_02_NO_SF",2010-09-20,"SF","NO",22,25,-3,"2010"
"2744","2010_02_NYG_IND",2010-09-19,"IND","NYG",38,14,24,"2010"
"2745","2010_02_PHI_DET",2010-09-19,"DET","PHI",32,35,-3,"2010"
"2746","2010_02_PIT_TEN",2010-09-19,"TEN","PIT",11,19,-8,"2010"
"2747","2010_02_SEA_DEN",2010-09-19,"DEN","SEA",31,14,17,"2010"
"2748","2010_02_STL_OAK",2010-09-19,"LV","LA",16,14,2,"2010"
"2749","2010_02_TB_CAR",2010-09-19,"CAR","TB",7,20,-13,"2010"
"2750","2010_03_ATL_NO",2010-09-26,"NO","ATL",24,27,-3,"2010"
"2751","2010_03_BUF_NE",2010-09-26,"NE","BUF",38,30,8,"2010"
"2752","2010_03_CIN_CAR",2010-09-26,"CAR","CIN",7,20,-13,"2010"
"2753","2010_03_CLE_BAL",2010-09-26,"BAL","CLE",24,17,7,"2010"
"2754","2010_03_DAL_HOU",2010-09-26,"HOU","DAL",13,27,-14,"2010"
"2755","2010_03_DET_MIN",2010-09-26,"MIN","DET",24,10,14,"2010"
"2756","2010_03_GB_CHI",2010-09-27,"CHI","GB",20,17,3,"2010"
"2757","2010_03_IND_DEN",2010-09-26,"DEN","IND",13,27,-14,"2010"
"2758","2010_03_NYJ_MIA",2010-09-26,"MIA","NYJ",23,31,-8,"2010"
"2759","2010_03_OAK_ARI",2010-09-26,"ARI","LV",24,23,1,"2010"
"2760","2010_03_PHI_JAX",2010-09-26,"JAX","PHI",3,28,-25,"2010"
"2761","2010_03_PIT_TB",2010-09-26,"TB","PIT",13,38,-25,"2010"
"2762","2010_03_SD_SEA",2010-09-26,"SEA","LAC",27,20,7,"2010"
"2763","2010_03_SF_KC",2010-09-26,"KC","SF",31,10,21,"2010"
"2764","2010_03_TEN_NYG",2010-09-26,"NYG","TEN",10,29,-19,"2010"
"2765","2010_03_WAS_STL",2010-09-26,"LA","WAS",30,16,14,"2010"
"2766","2010_04_ARI_SD",2010-10-03,"LAC","ARI",41,10,31,"2010"
"2767","2010_04_BAL_PIT",2010-10-03,"PIT","BAL",14,17,-3,"2010"
"2768","2010_04_CAR_NO",2010-10-03,"NO","CAR",16,14,2,"2010"
"2769","2010_04_CHI_NYG",2010-10-03,"NYG","CHI",17,3,14,"2010"
"2770","2010_04_CIN_CLE",2010-10-03,"CLE","CIN",23,20,3,"2010"
"2771","2010_04_DEN_TEN",2010-10-03,"TEN","DEN",20,26,-6,"2010"
"2772","2010_04_DET_GB",2010-10-03,"GB","DET",28,26,2,"2010"
"2773","2010_04_HOU_OAK",2010-10-03,"LV","HOU",24,31,-7,"2010"
"2774","2010_04_IND_JAX",2010-10-03,"JAX","IND",31,28,3,"2010"
"2775","2010_04_NE_MIA",2010-10-04,"MIA","NE",14,41,-27,"2010"
"2776","2010_04_NYJ_BUF",2010-10-03,"BUF","NYJ",14,38,-24,"2010"
"2777","2010_04_SEA_STL",2010-10-03,"LA","SEA",20,3,17,"2010"
"2778","2010_04_SF_ATL",2010-10-03,"ATL","SF",16,14,2,"2010"
"2779","2010_04_WAS_PHI",2010-10-03,"PHI","WAS",12,17,-5,"2010"
"2780","2010_05_ATL_CLE",2010-10-10,"CLE","ATL",10,20,-10,"2010"
"2781","2010_05_CHI_CAR",2010-10-10,"CAR","CHI",6,23,-17,"2010"
"2782","2010_05_DEN_BAL",2010-10-10,"BAL","DEN",31,17,14,"2010"
"2783","2010_05_GB_WAS",2010-10-10,"WAS","GB",16,13,3,"2010"
"2784","2010_05_JAX_BUF",2010-10-10,"BUF","JAX",26,36,-10,"2010"
"2785","2010_05_KC_IND",2010-10-10,"IND","KC",19,9,10,"2010"
"2786","2010_05_MIN_NYJ",2010-10-11,"NYJ","MIN",29,20,9,"2010"
"2787","2010_05_NO_ARI",2010-10-10,"ARI","NO",30,20,10,"2010"
"2788","2010_05_NYG_HOU",2010-10-10,"HOU","NYG",10,34,-24,"2010"
"2789","2010_05_PHI_SF",2010-10-10,"SF","PHI",24,27,-3,"2010"
"2790","2010_05_SD_OAK",2010-10-10,"LV","LAC",35,27,8,"2010"
"2791","2010_05_STL_DET",2010-10-10,"DET","LA",44,6,38,"2010"
"2792","2010_05_TB_CIN",2010-10-10,"CIN","TB",21,24,-3,"2010"
"2793","2010_05_TEN_DAL",2010-10-10,"DAL","TEN",27,34,-7,"2010"
"2794","2010_06_ATL_PHI",2010-10-17,"PHI","ATL",31,17,14,"2010"
"2795","2010_06_BAL_NE",2010-10-17,"NE","BAL",23,20,3,"2010"
"2796","2010_06_CLE_PIT",2010-10-17,"PIT","CLE",28,10,18,"2010"
"2797","2010_06_DAL_MIN",2010-10-17,"MIN","DAL",24,21,3,"2010"
"2798","2010_06_DET_NYG",2010-10-17,"NYG","DET",28,20,8,"2010"
"2799","2010_06_IND_WAS",2010-10-17,"WAS","IND",24,27,-3,"2010"
"2800","2010_06_KC_HOU",2010-10-17,"HOU","KC",35,31,4,"2010"
"2801","2010_06_MIA_GB",2010-10-17,"GB","MIA",20,23,-3,"2010"
"2802","2010_06_NO_TB",2010-10-17,"TB","NO",6,31,-25,"2010"
"2803","2010_06_NYJ_DEN",2010-10-17,"DEN","NYJ",20,24,-4,"2010"
"2804","2010_06_OAK_SF",2010-10-17,"SF","LV",17,9,8,"2010"
"2805","2010_06_SD_STL",2010-10-17,"LA","LAC",20,17,3,"2010"
"2806","2010_06_SEA_CHI",2010-10-17,"CHI","SEA",20,23,-3,"2010"
"2807","2010_06_TEN_JAX",2010-10-18,"JAX","TEN",3,30,-27,"2010"
"2808","2010_07_ARI_SEA",2010-10-24,"SEA","ARI",22,10,12,"2010"
"2809","2010_07_BUF_BAL",2010-10-24,"BAL","BUF",37,34,3,"2010"
"2810","2010_07_CIN_ATL",2010-10-24,"ATL","CIN",39,32,7,"2010"
"2811","2010_07_CLE_NO",2010-10-24,"NO","CLE",17,30,-13,"2010"
"2812","2010_07_JAX_KC",2010-10-24,"KC","JAX",42,20,22,"2010"
"2813","2010_07_MIN_GB",2010-10-24,"GB","MIN",28,24,4,"2010"
"2814","2010_07_NE_SD",2010-10-24,"LAC","NE",20,23,-3,"2010"
"2815","2010_07_NYG_DAL",2010-10-25,"DAL","NYG",35,41,-6,"2010"
"2816","2010_07_OAK_DEN",2010-10-24,"DEN","LV",14,59,-45,"2010"
"2817","2010_07_PHI_TEN",2010-10-24,"TEN","PHI",37,19,18,"2010"
"2818","2010_07_PIT_MIA",2010-10-24,"MIA","PIT",22,23,-1,"2010"
"2819","2010_07_SF_CAR",2010-10-24,"CAR","SF",23,20,3,"2010"
"2820","2010_07_STL_TB",2010-10-24,"TB","LA",18,17,1,"2010"
"2821","2010_07_WAS_CHI",2010-10-24,"CHI","WAS",14,17,-3,"2010"
"2822","2010_08_BUF_KC",2010-10-31,"KC","BUF",13,10,3,"2010"
"2823","2010_08_CAR_STL",2010-10-31,"LA","CAR",20,10,10,"2010"
"2824","2010_08_DEN_SF",2010-10-31,"SF","DEN",24,16,8,"2010"
"2825","2010_08_GB_NYJ",2010-10-31,"NYJ","GB",0,9,-9,"2010"
"2826","2010_08_HOU_IND",2010-11-01,"IND","HOU",30,17,13,"2010"
"2827","2010_08_JAX_DAL",2010-10-31,"DAL","JAX",17,35,-18,"2010"
"2828","2010_08_MIA_CIN",2010-10-31,"CIN","MIA",14,22,-8,"2010"
"2829","2010_08_MIN_NE",2010-10-31,"NE","MIN",28,18,10,"2010"
"2830","2010_08_PIT_NO",2010-10-31,"NO","PIT",20,10,10,"2010"
"2831","2010_08_SEA_OAK",2010-10-31,"LV","SEA",33,3,30,"2010"
"2832","2010_08_TB_ARI",2010-10-31,"ARI","TB",35,38,-3,"2010"
"2833","2010_08_TEN_SD",2010-10-31,"LAC","TEN",33,25,8,"2010"
"2834","2010_08_WAS_DET",2010-10-31,"DET","WAS",37,25,12,"2010"
"2835","2010_09_ARI_MIN",2010-11-07,"MIN","ARI",27,24,3,"2010"
"2836","2010_09_CHI_BUF",2010-11-07,"BUF","CHI",19,22,-3,"2010"
"2837","2010_09_DAL_GB",2010-11-07,"GB","DAL",45,7,38,"2010"
"2838","2010_09_IND_PHI",2010-11-07,"PHI","IND",26,24,2,"2010"
"2839","2010_09_KC_OAK",2010-11-07,"LV","KC",23,20,3,"2010"
"2840","2010_09_MIA_BAL",2010-11-07,"BAL","MIA",26,10,16,"2010"
"2841","2010_09_NE_CLE",2010-11-07,"CLE","NE",34,14,20,"2010"
"2842","2010_09_NO_CAR",2010-11-07,"CAR","NO",3,34,-31,"2010"
"2843","2010_09_NYG_SEA",2010-11-07,"SEA","NYG",7,41,-34,"2010"
"2844","2010_09_NYJ_DET",2010-11-07,"DET","NYJ",20,23,-3,"2010"
"2845","2010_09_PIT_CIN",2010-11-08,"CIN","PIT",21,27,-6,"2010"
"2846","2010_09_SD_HOU",2010-11-07,"HOU","LAC",23,29,-6,"2010"
"2847","2010_09_TB_ATL",2010-11-07,"ATL","TB",27,21,6,"2010"
"2848","2010_10_BAL_ATL",2010-11-11,"ATL","BAL",26,21,5,"2010"
"2849","2010_10_CAR_TB",2010-11-14,"TB","CAR",31,16,15,"2010"
"2850","2010_10_CIN_IND",2010-11-14,"IND","CIN",23,17,6,"2010"
"2851","2010_10_DAL_NYG",2010-11-14,"NYG","DAL",20,33,-13,"2010"
"2852","2010_10_DET_BUF",2010-11-14,"BUF","DET",14,12,2,"2010"
"2853","2010_10_HOU_JAX",2010-11-14,"JAX","HOU",31,24,7,"2010"
"2854","2010_10_KC_DEN",2010-11-14,"DEN","KC",49,29,20,"2010"
"2855","2010_10_MIN_CHI",2010-11-14,"CHI","MIN",27,13,14,"2010"
"2856","2010_10_NE_PIT",2010-11-14,"PIT","NE",26,39,-13,"2010"
"2857","2010_10_NYJ_CLE",2010-11-14,"CLE","NYJ",20,26,-6,"2010"
"2858","2010_10_PHI_WAS",2010-11-15,"WAS","PHI",28,59,-31,"2010"
"2859","2010_10_SEA_ARI",2010-11-14,"ARI","SEA",18,36,-18,"2010"
"2860","2010_10_STL_SF",2010-11-14,"SF","LA",23,20,3,"2010"
"2861","2010_10_TEN_MIA",2010-11-14,"MIA","TEN",29,17,12,"2010"
"2862","2010_11_ARI_KC",2010-11-21,"KC","ARI",31,13,18,"2010"
"2863","2010_11_ATL_STL",2010-11-21,"LA","ATL",17,34,-17,"2010"
"2864","2010_11_BAL_CAR",2010-11-21,"CAR","BAL",13,37,-24,"2010"
"2865","2010_11_BUF_CIN",2010-11-21,"CIN","BUF",31,49,-18,"2010"
"2866","2010_11_CHI_MIA",2010-11-18,"MIA","CHI",0,16,-16,"2010"
"2867","2010_11_CLE_JAX",2010-11-21,"JAX","CLE",24,20,4,"2010"
"2868","2010_11_DEN_SD",2010-11-22,"LAC","DEN",35,14,21,"2010"
"2869","2010_11_DET_DAL",2010-11-21,"DAL","DET",35,19,16,"2010"
"2870","2010_11_GB_MIN",2010-11-21,"MIN","GB",3,31,-28,"2010"
"2871","2010_11_HOU_NYJ",2010-11-21,"NYJ","HOU",30,27,3,"2010"
"2872","2010_11_IND_NE",2010-11-21,"NE","IND",31,28,3,"2010"
"2873","2010_11_NYG_PHI",2010-11-21,"PHI","NYG",27,17,10,"2010"
"2874","2010_11_OAK_PIT",2010-11-21,"PIT","LV",35,3,32,"2010"
"2875","2010_11_SEA_NO",2010-11-21,"NO","SEA",34,19,15,"2010"
"2876","2010_11_TB_SF",2010-11-21,"SF","TB",0,21,-21,"2010"
"2877","2010_11_WAS_TEN",2010-11-21,"TEN","WAS",16,19,-3,"2010"
"2878","2010_12_CAR_CLE",2010-11-28,"CLE","CAR",24,23,1,"2010"
"2879","2010_12_CIN_NYJ",2010-11-25,"NYJ","CIN",26,10,16,"2010"
"2880","2010_12_GB_ATL",2010-11-28,"ATL","GB",20,17,3,"2010"
"2881","2010_12_JAX_NYG",2010-11-28,"NYG","JAX",24,20,4,"2010"
"2882","2010_12_KC_SEA",2010-11-28,"SEA","KC",24,42,-18,"2010"
"2883","2010_12_MIA_OAK",2010-11-28,"LV","MIA",17,33,-16,"2010"
"2884","2010_12_MIN_WAS",2010-11-28,"WAS","MIN",13,17,-4,"2010"
"2885","2010_12_NE_DET",2010-11-25,"DET","NE",24,45,-21,"2010"
"2886","2010_12_NO_DAL",2010-11-25,"DAL","NO",27,30,-3,"2010"
"2887","2010_12_PHI_CHI",2010-11-28,"CHI","PHI",31,26,5,"2010"
"2888","2010_12_PIT_BUF",2010-11-28,"BUF","PIT",16,19,-3,"2010"
"2889","2010_12_SD_IND",2010-11-28,"IND","LAC",14,36,-22,"2010"
"2890","2010_12_SF_ARI",2010-11-29,"ARI","SF",6,27,-21,"2010"
"2891","2010_12_STL_DEN",2010-11-28,"DEN","LA",33,36,-3,"2010"
"2892","2010_12_TB_BAL",2010-11-28,"BAL","TB",17,10,7,"2010"
"2893","2010_12_TEN_HOU",2010-11-28,"HOU","TEN",20,0,20,"2010"
"2894","2010_13_ATL_TB",2010-12-05,"TB","ATL",24,28,-4,"2010"
"2895","2010_13_BUF_MIN",2010-12-05,"MIN","BUF",38,14,24,"2010"
"2896","2010_13_CAR_SEA",2010-12-05,"SEA","CAR",31,14,17,"2010"
"2897","2010_13_CHI_DET",2010-12-05,"DET","CHI",20,24,-4,"2010"
"2898","2010_13_CLE_MIA",2010-12-05,"MIA","CLE",10,13,-3,"2010"
"2899","2010_13_DAL_IND",2010-12-05,"IND","DAL",35,38,-3,"2010"
"2900","2010_13_DEN_KC",2010-12-05,"KC","DEN",10,6,4,"2010"
"2901","2010_13_HOU_PHI",2010-12-02,"PHI","HOU",34,24,10,"2010"
"2902","2010_13_JAX_TEN",2010-12-05,"TEN","JAX",6,17,-11,"2010"
"2903","2010_13_NO_CIN",2010-12-05,"CIN","NO",30,34,-4,"2010"
"2904","2010_13_NYJ_NE",2010-12-06,"NE","NYJ",45,3,42,"2010"
"2905","2010_13_OAK_SD",2010-12-05,"LAC","LV",13,28,-15,"2010"
"2906","2010_13_PIT_BAL",2010-12-05,"BAL","PIT",10,13,-3,"2010"
"2907","2010_13_SF_GB",2010-12-05,"GB","SF",34,16,18,"2010"
"2908","2010_13_STL_ARI",2010-12-05,"ARI","LA",6,19,-13,"2010"
"2909","2010_13_WAS_NYG",2010-12-05,"NYG","WAS",31,7,24,"2010"
"2910","2010_14_ATL_CAR",2010-12-12,"CAR","ATL",10,31,-21,"2010"
"2911","2010_14_BAL_HOU",2010-12-13,"HOU","BAL",28,34,-6,"2010"
"2912","2010_14_CIN_PIT",2010-12-12,"PIT","CIN",23,7,16,"2010"
"2913","2010_14_CLE_BUF",2010-12-12,"BUF","CLE",13,6,7,"2010"
"2914","2010_14_DEN_ARI",2010-12-12,"ARI","DEN",43,13,30,"2010"
"2915","2010_14_GB_DET",2010-12-12,"DET","GB",7,3,4,"2010"
"2916","2010_14_IND_TEN",2010-12-09,"TEN","IND",28,30,-2,"2010"
"2917","2010_14_KC_SD",2010-12-12,"LAC","KC",31,0,31,"2010"
"2918","2010_14_MIA_NYJ",2010-12-12,"NYJ","MIA",6,10,-4,"2010"
"2919","2010_14_NE_CHI",2010-12-12,"CHI","NE",7,36,-29,"2010"
"2920","2010_14_NYG_MIN",2010-12-13,"MIN","NYG",3,21,-18,"2010"
"2921","2010_14_OAK_JAX",2010-12-12,"JAX","LV",38,31,7,"2010"
"2922","2010_14_PHI_DAL",2010-12-12,"DAL","PHI",27,30,-3,"2010"
"2923","2010_14_SEA_SF",2010-12-12,"SF","SEA",40,21,19,"2010"
"2924","2010_14_STL_NO",2010-12-12,"NO","LA",31,13,18,"2010"
"2925","2010_14_TB_WAS",2010-12-12,"WAS","TB",16,17,-1,"2010"
"2926","2010_15_ARI_CAR",2010-12-19,"CAR","ARI",19,12,7,"2010"
"2927","2010_15_ATL_SEA",2010-12-19,"SEA","ATL",18,34,-16,"2010"
"2928","2010_15_BUF_MIA",2010-12-19,"MIA","BUF",14,17,-3,"2010"
"2929","2010_15_CHI_MIN",2010-12-20,"MIN","CHI",14,40,-26,"2010"
"2930","2010_15_CLE_CIN",2010-12-19,"CIN","CLE",19,17,2,"2010"
"2931","2010_15_DEN_OAK",2010-12-19,"LV","DEN",39,23,16,"2010"
"2932","2010_15_DET_TB",2010-12-19,"TB","DET",20,23,-3,"2010"
"2933","2010_15_GB_NE",2010-12-19,"NE","GB",31,27,4,"2010"
"2934","2010_15_HOU_TEN",2010-12-19,"TEN","HOU",31,17,14,"2010"
"2935","2010_15_JAX_IND",2010-12-19,"IND","JAX",34,24,10,"2010"
"2936","2010_15_KC_STL",2010-12-19,"LA","KC",13,27,-14,"2010"
"2937","2010_15_NO_BAL",2010-12-19,"BAL","NO",30,24,6,"2010"
"2938","2010_15_NYJ_PIT",2010-12-19,"PIT","NYJ",17,22,-5,"2010"
"2939","2010_15_PHI_NYG",2010-12-19,"NYG","PHI",31,38,-7,"2010"
"2940","2010_15_SF_SD",2010-12-16,"LAC","SF",34,7,27,"2010"
"2941","2010_15_WAS_DAL",2010-12-19,"DAL","WAS",33,30,3,"2010"
"2942","2010_16_BAL_CLE",2010-12-26,"CLE","BAL",10,20,-10,"2010"
"2943","2010_16_CAR_PIT",2010-12-23,"PIT","CAR",27,3,24,"2010"
"2944","2010_16_DAL_ARI",2010-12-25,"ARI","DAL",27,26,1,"2010"
"2945","2010_16_DET_MIA",2010-12-26,"MIA","DET",27,34,-7,"2010"
"2946","2010_16_HOU_DEN",2010-12-26,"DEN","HOU",24,23,1,"2010"
"2947","2010_16_IND_OAK",2010-12-26,"LV","IND",26,31,-5,"2010"
"2948","2010_16_MIN_PHI",2010-12-28,"PHI","MIN",14,24,-10,"2010"
"2949","2010_16_NE_BUF",2010-12-26,"BUF","NE",3,34,-31,"2010"
"2950","2010_16_NO_ATL",2010-12-27,"ATL","NO",14,17,-3,"2010"
"2951","2010_16_NYG_GB",2010-12-26,"GB","NYG",45,17,28,"2010"
"2952","2010_16_NYJ_CHI",2010-12-26,"CHI","NYJ",38,34,4,"2010"
"2953","2010_16_SD_CIN",2010-12-26,"CIN","LAC",34,20,14,"2010"
"2954","2010_16_SEA_TB",2010-12-26,"TB","SEA",38,15,23,"2010"
"2955","2010_16_SF_STL",2010-12-26,"LA","SF",25,17,8,"2010"
"2956","2010_16_TEN_KC",2010-12-26,"KC","TEN",34,14,20,"2010"
"2957","2010_16_WAS_JAX",2010-12-26,"JAX","WAS",17,20,-3,"2010"
"2958","2011_01_ATL_CHI",2011-09-11,"CHI","ATL",30,12,18,"2011"
"2959","2011_01_BUF_KC",2011-09-11,"KC","BUF",7,41,-34,"2011"
"2960","2011_01_CAR_ARI",2011-09-11,"ARI","CAR",28,21,7,"2011"
"2961","2011_01_CIN_CLE",2011-09-11,"CLE","CIN",17,27,-10,"2011"
"2962","2011_01_DAL_NYJ",2011-09-11,"NYJ","DAL",27,24,3,"2011"
"2963","2011_01_DET_TB",2011-09-11,"TB","DET",20,27,-7,"2011"
"2964","2011_01_IND_HOU",2011-09-11,"HOU","IND",34,7,27,"2011"
"2965","2011_01_MIN_SD",2011-09-11,"LAC","MIN",24,17,7,"2011"
"2966","2011_01_NE_MIA",2011-09-12,"MIA","NE",24,38,-14,"2011"
"2967","2011_01_NO_GB",2011-09-08,"GB","NO",42,34,8,"2011"
"2968","2011_01_NYG_WAS",2011-09-11,"WAS","NYG",28,14,14,"2011"
"2969","2011_01_OAK_DEN",2011-09-12,"DEN","LV",20,23,-3,"2011"
"2970","2011_01_PHI_STL",2011-09-11,"LA","PHI",13,31,-18,"2011"
"2971","2011_01_PIT_BAL",2011-09-11,"BAL","PIT",35,7,28,"2011"
"2972","2011_01_SEA_SF",2011-09-11,"SF","SEA",33,17,16,"2011"
"2973","2011_01_TEN_JAX",2011-09-11,"JAX","TEN",16,14,2,"2011"
"2974","2011_02_ARI_WAS",2011-09-18,"WAS","ARI",22,21,1,"2011"
"2975","2011_02_BAL_TEN",2011-09-18,"TEN","BAL",26,13,13,"2011"
"2976","2011_02_CHI_NO",2011-09-18,"NO","CHI",30,13,17,"2011"
"2977","2011_02_CIN_DEN",2011-09-18,"DEN","CIN",24,22,2,"2011"
"2978","2011_02_CLE_IND",2011-09-18,"IND","CLE",19,27,-8,"2011"
"2979","2011_02_DAL_SF",2011-09-18,"SF","DAL",24,27,-3,"2011"
"2980","2011_02_GB_CAR",2011-09-18,"CAR","GB",23,30,-7,"2011"
"2981","2011_02_HOU_MIA",2011-09-18,"MIA","HOU",13,23,-10,"2011"
"2982","2011_02_JAX_NYJ",2011-09-18,"NYJ","JAX",32,3,29,"2011"
"2983","2011_02_KC_DET",2011-09-18,"DET","KC",48,3,45,"2011"
"2984","2011_02_OAK_BUF",2011-09-18,"BUF","LV",38,35,3,"2011"
"2985","2011_02_PHI_ATL",2011-09-18,"ATL","PHI",35,31,4,"2011"
"2986","2011_02_SD_NE",2011-09-18,"NE","LAC",35,21,14,"2011"
"2987","2011_02_SEA_PIT",2011-09-18,"PIT","SEA",24,0,24,"2011"
"2988","2011_02_STL_NYG",2011-09-19,"NYG","LA",28,16,12,"2011"
"2989","2011_02_TB_MIN",2011-09-18,"MIN","TB",20,24,-4,"2011"
"2990","2011_03_ARI_SEA",2011-09-25,"SEA","ARI",13,10,3,"2011"
"2991","2011_03_ATL_TB",2011-09-25,"TB","ATL",16,13,3,"2011"
"2992","2011_03_BAL_STL",2011-09-25,"LA","BAL",7,37,-30,"2011"
"2993","2011_03_DEN_TEN",2011-09-25,"TEN","DEN",17,14,3,"2011"
"2994","2011_03_DET_MIN",2011-09-25,"MIN","DET",23,26,-3,"2011"
"2995","2011_03_GB_CHI",2011-09-25,"CHI","GB",17,27,-10,"2011"
"2996","2011_03_HOU_NO",2011-09-25,"NO","HOU",40,33,7,"2011"
"2997","2011_03_JAX_CAR",2011-09-25,"CAR","JAX",16,10,6,"2011"
"2998","2011_03_KC_SD",2011-09-25,"LAC","KC",20,17,3,"2011"
"2999","2011_03_MIA_CLE",2011-09-25,"CLE","MIA",17,16,1,"2011"
"3000","2011_03_NE_BUF",2011-09-25,"BUF","NE",34,31,3,"2011"
"3001","2011_03_NYG_PHI",2011-09-25,"PHI","NYG",16,29,-13,"2011"
"3002","2011_03_NYJ_OAK",2011-09-25,"LV","NYJ",34,24,10,"2011"
"3003","2011_03_PIT_IND",2011-09-25,"IND","PIT",20,23,-3,"2011"
"3004","2011_03_SF_CIN",2011-09-25,"CIN","SF",8,13,-5,"2011"
"3005","2011_03_WAS_DAL",2011-09-26,"DAL","WAS",18,16,2,"2011"
"3006","2011_04_ATL_SEA",2011-10-02,"SEA","ATL",28,30,-2,"2011"
"3007","2011_04_BUF_CIN",2011-10-02,"CIN","BUF",23,20,3,"2011"
"3008","2011_04_CAR_CHI",2011-10-02,"CHI","CAR",34,29,5,"2011"
"3009","2011_04_DEN_GB",2011-10-02,"GB","DEN",49,23,26,"2011"
"3010","2011_04_DET_DAL",2011-10-02,"DAL","DET",30,34,-4,"2011"
"3011","2011_04_IND_TB",2011-10-03,"TB","IND",24,17,7,"2011"
"3012","2011_04_MIA_SD",2011-10-02,"LAC","MIA",26,16,10,"2011"
"3013","2011_04_MIN_KC",2011-10-02,"KC","MIN",22,17,5,"2011"
"3014","2011_04_NE_OAK",2011-10-02,"LV","NE",19,31,-12,"2011"
"3015","2011_04_NO_JAX",2011-10-02,"JAX","NO",10,23,-13,"2011"
"3016","2011_04_NYG_ARI",2011-10-02,"ARI","NYG",27,31,-4,"2011"
"3017","2011_04_NYJ_BAL",2011-10-02,"BAL","NYJ",34,17,17,"2011"
"3018","2011_04_PIT_HOU",2011-10-02,"HOU","PIT",17,10,7,"2011"
"3019","2011_04_SF_PHI",2011-10-02,"PHI","SF",23,24,-1,"2011"
"3020","2011_04_TEN_CLE",2011-10-02,"CLE","TEN",13,31,-18,"2011"
"3021","2011_04_WAS_STL",2011-10-02,"LA","WAS",10,17,-7,"2011"
"3022","2011_05_ARI_MIN",2011-10-09,"MIN","ARI",34,10,24,"2011"
"3023","2011_05_CHI_DET",2011-10-10,"DET","CHI",24,13,11,"2011"
"3024","2011_05_CIN_JAX",2011-10-09,"JAX","CIN",20,30,-10,"2011"
"3025","2011_05_GB_ATL",2011-10-09,"ATL","GB",14,25,-11,"2011"
"3026","2011_05_KC_IND",2011-10-09,"IND","KC",24,28,-4,"2011"
"3027","2011_05_NO_CAR",2011-10-09,"CAR","NO",27,30,-3,"2011"
"3028","2011_05_NYJ_NE",2011-10-09,"NE","NYJ",30,21,9,"2011"
"3029","2011_05_OAK_HOU",2011-10-09,"HOU","LV",20,25,-5,"2011"
"3030","2011_05_PHI_BUF",2011-10-09,"BUF","PHI",31,24,7,"2011"
"3031","2011_05_SD_DEN",2011-10-09,"DEN","LAC",24,29,-5,"2011"
"3032","2011_05_SEA_NYG",2011-10-09,"NYG","SEA",25,36,-11,"2011"
"3033","2011_05_TB_SF",2011-10-09,"SF","TB",48,3,45,"2011"
"3034","2011_05_TEN_PIT",2011-10-09,"PIT","TEN",38,17,21,"2011"
"3035","2011_06_BUF_NYG",2011-10-16,"NYG","BUF",27,24,3,"2011"
"3036","2011_06_CAR_ATL",2011-10-16,"ATL","CAR",31,17,14,"2011"
"3037","2011_06_CLE_OAK",2011-10-16,"LV","CLE",24,17,7,"2011"
"3038","2011_06_DAL_NE",2011-10-16,"NE","DAL",20,16,4,"2011"
"3039","2011_06_HOU_BAL",2011-10-16,"BAL","HOU",29,14,15,"2011"
"3040","2011_06_IND_CIN",2011-10-16,"CIN","IND",27,17,10,"2011"
"3041","2011_06_JAX_PIT",2011-10-16,"PIT","JAX",17,13,4,"2011"
"3042","2011_06_MIA_NYJ",2011-10-17,"NYJ","MIA",24,6,18,"2011"
"3043","2011_06_MIN_CHI",2011-10-16,"CHI","MIN",39,10,29,"2011"
"3044","2011_06_NO_TB",2011-10-16,"TB","NO",26,20,6,"2011"
"3045","2011_06_PHI_WAS",2011-10-16,"WAS","PHI",13,20,-7,"2011"
"3046","2011_06_SF_DET",2011-10-16,"DET","SF",19,25,-6,"2011"
"3047","2011_06_STL_GB",2011-10-16,"GB","LA",24,3,21,"2011"
"3048","2011_07_ATL_DET",2011-10-23,"DET","ATL",16,23,-7,"2011"
"3049","2011_07_BAL_JAX",2011-10-24,"JAX","BAL",12,7,5,"2011"
"3050","2011_07_CHI_TB",2011-10-23,"TB","CHI",18,24,-6,"2011"
"3051","2011_07_DEN_MIA",2011-10-23,"MIA","DEN",15,18,-3,"2011"
"3052","2011_07_GB_MIN",2011-10-23,"MIN","GB",27,33,-6,"2011"
"3053","2011_07_HOU_TEN",2011-10-23,"TEN","HOU",7,41,-34,"2011"
"3054","2011_07_IND_NO",2011-10-23,"NO","IND",62,7,55,"2011"
"3055","2011_07_KC_OAK",2011-10-23,"LV","KC",0,28,-28,"2011"
"3056","2011_07_PIT_ARI",2011-10-23,"ARI","PIT",20,32,-12,"2011"
"3057","2011_07_SD_NYJ",2011-10-23,"NYJ","LAC",27,21,6,"2011"
"3058","2011_07_SEA_CLE",2011-10-23,"CLE","SEA",6,3,3,"2011"
"3059","2011_07_STL_DAL",2011-10-23,"DAL","LA",34,7,27,"2011"
"3060","2011_07_WAS_CAR",2011-10-23,"CAR","WAS",33,20,13,"2011"
"3061","2011_08_ARI_BAL",2011-10-30,"BAL","ARI",30,27,3,"2011"
"3062","2011_08_CIN_SEA",2011-10-30,"SEA","CIN",12,34,-22,"2011"
"3063","2011_08_CLE_SF",2011-10-30,"SF","CLE",20,10,10,"2011"
"3064","2011_08_DAL_PHI",2011-10-30,"PHI","DAL",34,7,27,"2011"
"3065","2011_08_DET_DEN",2011-10-30,"DEN","DET",10,45,-35,"2011"
"3066","2011_08_IND_TEN",2011-10-30,"TEN","IND",27,10,17,"2011"
"3067","2011_08_JAX_HOU",2011-10-30,"HOU","JAX",24,14,10,"2011"
"3068","2011_08_MIA_NYG",2011-10-30,"NYG","MIA",20,17,3,"2011"
"3069","2011_08_MIN_CAR",2011-10-30,"CAR","MIN",21,24,-3,"2011"
"3070","2011_08_NE_PIT",2011-10-30,"PIT","NE",25,17,8,"2011"
"3071","2011_08_NO_STL",2011-10-30,"LA","NO",31,21,10,"2011"
"3072","2011_08_SD_KC",2011-10-31,"KC","LAC",23,20,3,"2011"
"3073","2011_08_WAS_BUF",2011-10-30,"BUF","WAS",23,0,23,"2011"
"3074","2011_09_ATL_IND",2011-11-06,"IND","ATL",7,31,-24,"2011"
"3075","2011_09_BAL_PIT",2011-11-06,"PIT","BAL",20,23,-3,"2011"
"3076","2011_09_CHI_PHI",2011-11-07,"PHI","CHI",24,30,-6,"2011"
"3077","2011_09_CIN_TEN",2011-11-06,"TEN","CIN",17,24,-7,"2011"
"3078","2011_09_CLE_HOU",2011-11-06,"HOU","CLE",30,12,18,"2011"
"3079","2011_09_DEN_OAK",2011-11-06,"LV","DEN",24,38,-14,"2011"
"3080","2011_09_GB_SD",2011-11-06,"LAC","GB",38,45,-7,"2011"
"3081","2011_09_MIA_KC",2011-11-06,"KC","MIA",3,31,-28,"2011"
"3082","2011_09_NYG_NE",2011-11-06,"NE","NYG",20,24,-4,"2011"
"3083","2011_09_NYJ_BUF",2011-11-06,"BUF","NYJ",11,27,-16,"2011"
"3084","2011_09_SEA_DAL",2011-11-06,"DAL","SEA",23,13,10,"2011"
"3085","2011_09_SF_WAS",2011-11-06,"WAS","SF",11,19,-8,"2011"
"3086","2011_09_STL_ARI",2011-11-06,"ARI","LA",19,13,6,"2011"
"3087","2011_09_TB_NO",2011-11-06,"NO","TB",27,16,11,"2011"
"3088","2011_10_ARI_PHI",2011-11-13,"PHI","ARI",17,21,-4,"2011"
"3089","2011_10_BAL_SEA",2011-11-13,"SEA","BAL",22,17,5,"2011"
"3090","2011_10_BUF_DAL",2011-11-13,"DAL","BUF",44,7,37,"2011"
"3091","2011_10_DEN_KC",2011-11-13,"KC","DEN",10,17,-7,"2011"
"3092","2011_10_DET_CHI",2011-11-13,"CHI","DET",37,13,24,"2011"
"3093","2011_10_HOU_TB",2011-11-13,"TB","HOU",9,37,-28,"2011"
"3094","2011_10_JAX_IND",2011-11-13,"IND","JAX",3,17,-14,"2011"
"3095","2011_10_MIN_GB",2011-11-14,"GB","MIN",45,7,38,"2011"
"3096","2011_10_NE_NYJ",2011-11-13,"NYJ","NE",16,37,-21,"2011"
"3097","2011_10_NO_ATL",2011-11-13,"ATL","NO",23,26,-3,"2011"
"3098","2011_10_NYG_SF",2011-11-13,"SF","NYG",27,20,7,"2011"
"3099","2011_10_OAK_SD",2011-11-10,"LAC","LV",17,24,-7,"2011"
"3100","2011_10_PIT_CIN",2011-11-13,"CIN","PIT",17,24,-7,"2011"
"3101","2011_10_STL_CLE",2011-11-13,"CLE","LA",12,13,-1,"2011"
"3102","2011_10_TEN_CAR",2011-11-13,"CAR","TEN",3,30,-27,"2011"
"3103","2011_10_WAS_MIA",2011-11-13,"MIA","WAS",20,9,11,"2011"
"3104","2011_11_ARI_SF",2011-11-20,"SF","ARI",23,7,16,"2011"
"3105","2011_11_BUF_MIA",2011-11-20,"MIA","BUF",35,8,27,"2011"
"3106","2011_11_CAR_DET",2011-11-20,"DET","CAR",49,35,14,"2011"
"3107","2011_11_CIN_BAL",2011-11-20,"BAL","CIN",31,24,7,"2011"
"3108","2011_11_DAL_WAS",2011-11-20,"WAS","DAL",24,27,-3,"2011"
"3109","2011_11_JAX_CLE",2011-11-20,"CLE","JAX",14,10,4,"2011"
"3110","2011_11_KC_NE",2011-11-21,"NE","KC",34,3,31,"2011"
"3111","2011_11_NYJ_DEN",2011-11-17,"DEN","NYJ",17,13,4,"2011"
"3112","2011_11_OAK_MIN",2011-11-20,"MIN","LV",21,27,-6,"2011"
"3113","2011_11_PHI_NYG",2011-11-20,"NYG","PHI",10,17,-7,"2011"
"3114","2011_11_SD_CHI",2011-11-20,"CHI","LAC",31,20,11,"2011"
"3115","2011_11_SEA_STL",2011-11-20,"LA","SEA",7,24,-17,"2011"
"3116","2011_11_TB_GB",2011-11-20,"GB","TB",35,26,9,"2011"
"3117","2011_11_TEN_ATL",2011-11-20,"ATL","TEN",23,17,6,"2011"
"3118","2011_12_ARI_STL",2011-11-27,"LA","ARI",20,23,-3,"2011"
"3119","2011_12_BUF_NYJ",2011-11-27,"NYJ","BUF",28,24,4,"2011"
"3120","2011_12_CAR_IND",2011-11-27,"IND","CAR",19,27,-8,"2011"
"3121","2011_12_CHI_OAK",2011-11-27,"LV","CHI",25,20,5,"2011"
"3122","2011_12_CLE_CIN",2011-11-27,"CIN","CLE",23,20,3,"2011"
"3123","2011_12_DEN_SD",2011-11-27,"LAC","DEN",13,16,-3,"2011"
"3124","2011_12_GB_DET",2011-11-24,"DET","GB",15,27,-12,"2011"
"3125","2011_12_HOU_JAX",2011-11-27,"JAX","HOU",13,20,-7,"2011"
"3126","2011_12_MIA_DAL",2011-11-24,"DAL","MIA",20,19,1,"2011"
"3127","2011_12_MIN_ATL",2011-11-27,"ATL","MIN",24,14,10,"2011"
"3128","2011_12_NE_PHI",2011-11-27,"PHI","NE",20,38,-18,"2011"
"3129","2011_12_NYG_NO",2011-11-28,"NO","NYG",49,24,25,"2011"
"3130","2011_12_PIT_KC",2011-11-27,"KC","PIT",9,13,-4,"2011"
"3131","2011_12_SF_BAL",2011-11-24,"BAL","SF",16,6,10,"2011"
"3132","2011_12_TB_TEN",2011-11-27,"TEN","TB",23,17,6,"2011"
"3133","2011_12_WAS_SEA",2011-11-27,"SEA","WAS",17,23,-6,"2011"
"3134","2011_13_ATL_HOU",2011-12-04,"HOU","ATL",17,10,7,"2011"
"3135","2011_13_BAL_CLE",2011-12-04,"CLE","BAL",10,24,-14,"2011"
"3136","2011_13_CAR_TB",2011-12-04,"TB","CAR",19,38,-19,"2011"
"3137","2011_13_CIN_PIT",2011-12-04,"PIT","CIN",35,7,28,"2011"
"3138","2011_13_DAL_ARI",2011-12-04,"ARI","DAL",19,13,6,"2011"
"3139","2011_13_DEN_MIN",2011-12-04,"MIN","DEN",32,35,-3,"2011"
"3140","2011_13_DET_NO",2011-12-04,"NO","DET",37,23,14,"2011"
"3141","2011_13_GB_NYG",2011-12-04,"NYG","GB",35,38,-3,"2011"
"3142","2011_13_IND_NE",2011-12-04,"NE","IND",31,24,7,"2011"
"3143","2011_13_KC_CHI",2011-12-04,"CHI","KC",3,10,-7,"2011"
"3144","2011_13_NYJ_WAS",2011-12-04,"WAS","NYJ",19,34,-15,"2011"
"3145","2011_13_OAK_MIA",2011-12-04,"MIA","LV",34,14,20,"2011"
"3146","2011_13_PHI_SEA",2011-12-01,"SEA","PHI",31,14,17,"2011"
"3147","2011_13_SD_JAX",2011-12-05,"JAX","LAC",14,38,-24,"2011"
"3148","2011_13_STL_SF",2011-12-04,"SF","LA",26,0,26,"2011"
"3149","2011_13_TEN_BUF",2011-12-04,"BUF","TEN",17,23,-6,"2011"
"3150","2011_14_ATL_CAR",2011-12-11,"CAR","ATL",23,31,-8,"2011"
"3151","2011_14_BUF_SD",2011-12-11,"LAC","BUF",37,10,27,"2011"
"3152","2011_14_CHI_DEN",2011-12-11,"DEN","CHI",13,10,3,"2011"
"3153","2011_14_CLE_PIT",2011-12-08,"PIT","CLE",14,3,11,"2011"
"3154","2011_14_HOU_CIN",2011-12-11,"CIN","HOU",19,20,-1,"2011"
"3155","2011_14_IND_BAL",2011-12-11,"BAL","IND",24,10,14,"2011"
"3156","2011_14_KC_NYJ",2011-12-11,"NYJ","KC",37,10,27,"2011"
"3157","2011_14_MIN_DET",2011-12-11,"DET","MIN",34,28,6,"2011"
"3158","2011_14_NE_WAS",2011-12-11,"WAS","NE",27,34,-7,"2011"
"3159","2011_14_NO_TEN",2011-12-11,"TEN","NO",17,22,-5,"2011"
"3160","2011_14_NYG_DAL",2011-12-11,"DAL","NYG",34,37,-3,"2011"
"3161","2011_14_OAK_GB",2011-12-11,"GB","LV",46,16,30,"2011"
"3162","2011_14_PHI_MIA",2011-12-11,"MIA","PHI",10,26,-16,"2011"
"3163","2011_14_SF_ARI",2011-12-11,"ARI","SF",21,19,2,"2011"
"3164","2011_14_STL_SEA",2011-12-12,"SEA","LA",30,13,17,"2011"
"3165","2011_14_TB_JAX",2011-12-11,"JAX","TB",41,14,27,"2011"
"3166","2011_15_BAL_SD",2011-12-18,"LAC","BAL",34,14,20,"2011"
"3167","2011_15_CAR_HOU",2011-12-18,"HOU","CAR",13,28,-15,"2011"
"3168","2011_15_CIN_STL",2011-12-18,"LA","CIN",13,20,-7,"2011"
"3169","2011_15_CLE_ARI",2011-12-18,"ARI","CLE",20,17,3,"2011"
"3170","2011_15_DAL_TB",2011-12-17,"TB","DAL",15,31,-16,"2011"
"3171","2011_15_DET_OAK",2011-12-18,"LV","DET",27,28,-1,"2011"
"3172","2011_15_GB_KC",2011-12-18,"KC","GB",19,14,5,"2011"
"3173","2011_15_JAX_ATL",2011-12-15,"ATL","JAX",41,14,27,"2011"
"3174","2011_15_MIA_BUF",2011-12-18,"BUF","MIA",23,30,-7,"2011"
"3175","2011_15_NE_DEN",2011-12-18,"DEN","NE",23,41,-18,"2011"
"3176","2011_15_NO_MIN",2011-12-18,"MIN","NO",20,42,-22,"2011"
"3177","2011_15_NYJ_PHI",2011-12-18,"PHI","NYJ",45,19,26,"2011"
"3178","2011_15_PIT_SF",2011-12-19,"SF","PIT",20,3,17,"2011"
"3179","2011_15_SEA_CHI",2011-12-18,"CHI","SEA",14,38,-24,"2011"
"3180","2011_15_TEN_IND",2011-12-18,"IND","TEN",27,13,14,"2011"
"3181","2011_15_WAS_NYG",2011-12-18,"NYG","WAS",10,23,-13,"2011"
"3182","2011_16_ARI_CIN",2011-12-24,"CIN","ARI",23,16,7,"2011"
"3183","2011_16_ATL_NO",2011-12-26,"NO","ATL",45,16,29,"2011"
"3184","2011_16_CHI_GB",2011-12-25,"GB","CHI",35,21,14,"2011"
"3185","2011_16_CLE_BAL",2011-12-24,"BAL","CLE",20,14,6,"2011"
"3186","2011_16_DEN_BUF",2011-12-24,"BUF","DEN",40,14,26,"2011"
"3187","2011_16_HOU_IND",2011-12-22,"IND","HOU",19,16,3,"2011"
"3188","2011_16_JAX_TEN",2011-12-24,"TEN","JAX",23,17,6,"2011"
"3189","2011_16_MIA_NE",2011-12-24,"NE","MIA",27,24,3,"2011"
"3190","2011_16_MIN_WAS",2011-12-24,"WAS","MIN",26,33,-7,"2011"
"3191","2011_16_NYG_NYJ",2011-12-24,"NYJ","NYG",14,29,-15,"2011"
"3192","2011_16_OAK_KC",2011-12-24,"KC","LV",13,16,-3,"2011"
"3193","2011_16_PHI_DAL",2011-12-24,"DAL","PHI",7,20,-13,"2011"
"3194","2011_16_SD_DET",2011-12-24,"DET","LAC",38,10,28,"2011"
"3195","2011_16_SF_SEA",2011-12-24,"SEA","SF",17,19,-2,"2011"
"3196","2011_16_STL_PIT",2011-12-24,"PIT","LA",27,0,27,"2011"
"3197","2011_16_TB_CAR",2011-12-24,"CAR","TB",48,16,32,"2011"
"3198","2012_01_ATL_KC",2012-09-09,"KC","ATL",24,40,-16,"2012"
"3199","2012_01_BUF_NYJ",2012-09-09,"NYJ","BUF",48,28,20,"2012"
"3200","2012_01_CAR_TB",2012-09-09,"TB","CAR",16,10,6,"2012"
"3201","2012_01_CIN_BAL",2012-09-10,"BAL","CIN",44,13,31,"2012"
"3202","2012_01_DAL_NYG",2012-09-05,"NYG","DAL",17,24,-7,"2012"
"3203","2012_01_IND_CHI",2012-09-09,"CHI","IND",41,21,20,"2012"
"3204","2012_01_JAX_MIN",2012-09-09,"MIN","JAX",26,23,3,"2012"
"3205","2012_01_MIA_HOU",2012-09-09,"HOU","MIA",30,10,20,"2012"
"3206","2012_01_NE_TEN",2012-09-09,"TEN","NE",13,34,-21,"2012"
"3207","2012_01_PHI_CLE",2012-09-09,"CLE","PHI",16,17,-1,"2012"
"3208","2012_01_PIT_DEN",2012-09-09,"DEN","PIT",31,19,12,"2012"
"3209","2012_01_SD_OAK",2012-09-10,"LV","LAC",14,22,-8,"2012"
"3210","2012_01_SEA_ARI",2012-09-09,"ARI","SEA",20,16,4,"2012"
"3211","2012_01_SF_GB",2012-09-09,"GB","SF",22,30,-8,"2012"
"3212","2012_01_STL_DET",2012-09-09,"DET","LA",27,23,4,"2012"
"3213","2012_01_WAS_NO",2012-09-09,"NO","WAS",32,40,-8,"2012"
"3214","2012_02_ARI_NE",2012-09-16,"NE","ARI",18,20,-2,"2012"
"3215","2012_02_BAL_PHI",2012-09-16,"PHI","BAL",24,23,1,"2012"
"3216","2012_02_CHI_GB",2012-09-13,"GB","CHI",23,10,13,"2012"
"3217","2012_02_CLE_CIN",2012-09-16,"CIN","CLE",34,27,7,"2012"
"3218","2012_02_DAL_SEA",2012-09-16,"SEA","DAL",27,7,20,"2012"
"3219","2012_02_DEN_ATL",2012-09-17,"ATL","DEN",27,21,6,"2012"
"3220","2012_02_DET_SF",2012-09-16,"SF","DET",27,19,8,"2012"
"3221","2012_02_HOU_JAX",2012-09-16,"JAX","HOU",7,27,-20,"2012"
"3222","2012_02_KC_BUF",2012-09-16,"BUF","KC",35,17,18,"2012"
"3223","2012_02_MIN_IND",2012-09-16,"IND","MIN",23,20,3,"2012"
"3224","2012_02_NO_CAR",2012-09-16,"CAR","NO",35,27,8,"2012"
"3225","2012_02_NYJ_PIT",2012-09-16,"PIT","NYJ",27,10,17,"2012"
"3226","2012_02_OAK_MIA",2012-09-16,"MIA","LV",35,13,22,"2012"
"3227","2012_02_TB_NYG",2012-09-16,"NYG","TB",41,34,7,"2012"
"3228","2012_02_TEN_SD",2012-09-16,"LAC","TEN",38,10,28,"2012"
"3229","2012_02_WAS_STL",2012-09-16,"LA","WAS",31,28,3,"2012"
"3230","2012_03_ATL_SD",2012-09-23,"LAC","ATL",3,27,-24,"2012"
"3231","2012_03_BUF_CLE",2012-09-23,"CLE","BUF",14,24,-10,"2012"
"3232","2012_03_CIN_WAS",2012-09-23,"WAS","CIN",31,38,-7,"2012"
"3233","2012_03_DET_TEN",2012-09-23,"TEN","DET",44,41,3,"2012"
"3234","2012_03_GB_SEA",2012-09-24,"SEA","GB",14,12,2,"2012"
"3235","2012_03_HOU_DEN",2012-09-23,"DEN","HOU",25,31,-6,"2012"
"3236","2012_03_JAX_IND",2012-09-23,"IND","JAX",17,22,-5,"2012"
"3237","2012_03_KC_NO",2012-09-23,"NO","KC",24,27,-3,"2012"
"3238","2012_03_NE_BAL",2012-09-23,"BAL","NE",31,30,1,"2012"
"3239","2012_03_NYG_CAR",2012-09-20,"CAR","NYG",7,36,-29,"2012"
"3240","2012_03_NYJ_MIA",2012-09-23,"MIA","NYJ",20,23,-3,"2012"
"3241","2012_03_PHI_ARI",2012-09-23,"ARI","PHI",27,6,21,"2012"
"3242","2012_03_PIT_OAK",2012-09-23,"LV","PIT",34,31,3,"2012"
"3243","2012_03_SF_MIN",2012-09-23,"MIN","SF",24,13,11,"2012"
"3244","2012_03_STL_CHI",2012-09-23,"CHI","LA",23,6,17,"2012"
"3245","2012_03_TB_DAL",2012-09-23,"DAL","TB",16,10,6,"2012"
"3246","2012_04_CAR_ATL",2012-09-30,"ATL","CAR",30,28,2,"2012"
"3247","2012_04_CHI_DAL",2012-10-01,"DAL","CHI",18,34,-16,"2012"
"3248","2012_04_CIN_JAX",2012-09-30,"JAX","CIN",10,27,-17,"2012"
"3249","2012_04_CLE_BAL",2012-09-27,"BAL","CLE",23,16,7,"2012"
"3250","2012_04_MIA_ARI",2012-09-30,"ARI","MIA",24,21,3,"2012"
"3251","2012_04_MIN_DET",2012-09-30,"DET","MIN",13,20,-7,"2012"
"3252","2012_04_NE_BUF",2012-09-30,"BUF","NE",28,52,-24,"2012"
"3253","2012_04_NO_GB",2012-09-30,"GB","NO",28,27,1,"2012"
"3254","2012_04_NYG_PHI",2012-09-30,"PHI","NYG",19,17,2,"2012"
"3255","2012_04_OAK_DEN",2012-09-30,"DEN","LV",37,6,31,"2012"
"3256","2012_04_SD_KC",2012-09-30,"KC","LAC",20,37,-17,"2012"
"3257","2012_04_SEA_STL",2012-09-30,"LA","SEA",19,13,6,"2012"
"3258","2012_04_SF_NYJ",2012-09-30,"NYJ","SF",0,34,-34,"2012"
"3259","2012_04_TEN_HOU",2012-09-30,"HOU","TEN",38,14,24,"2012"
"3260","2012_04_WAS_TB",2012-09-30,"TB","WAS",22,24,-2,"2012"
"3261","2012_05_ARI_STL",2012-10-04,"LA","ARI",17,3,14,"2012"
"3262","2012_05_ATL_WAS",2012-10-07,"WAS","ATL",17,24,-7,"2012"
"3263","2012_05_BAL_KC",2012-10-07,"KC","BAL",6,9,-3,"2012"
"3264","2012_05_BUF_SF",2012-10-07,"SF","BUF",45,3,42,"2012"
"3265","2012_05_CHI_JAX",2012-10-07,"JAX","CHI",3,41,-38,"2012"
"3266","2012_05_CLE_NYG",2012-10-07,"NYG","CLE",41,27,14,"2012"
"3267","2012_05_DEN_NE",2012-10-07,"NE","DEN",31,21,10,"2012"
"3268","2012_05_GB_IND",2012-10-07,"IND","GB",30,27,3,"2012"
"3269","2012_05_HOU_NYJ",2012-10-08,"NYJ","HOU",17,23,-6,"2012"
"3270","2012_05_MIA_CIN",2012-10-07,"CIN","MIA",13,17,-4,"2012"
"3271","2012_05_PHI_PIT",2012-10-07,"PIT","PHI",16,14,2,"2012"
"3272","2012_05_SD_NO",2012-10-07,"NO","LAC",31,24,7,"2012"
"3273","2012_05_SEA_CAR",2012-10-07,"CAR","SEA",12,16,-4,"2012"
"3274","2012_05_TEN_MIN",2012-10-07,"MIN","TEN",30,7,23,"2012"
"3275","2012_06_BUF_ARI",2012-10-14,"ARI","BUF",16,19,-3,"2012"
"3276","2012_06_CIN_CLE",2012-10-14,"CLE","CIN",34,24,10,"2012"
"3277","2012_06_DAL_BAL",2012-10-14,"BAL","DAL",31,29,2,"2012"
"3278","2012_06_DEN_SD",2012-10-15,"LAC","DEN",24,35,-11,"2012"
"3279","2012_06_DET_PHI",2012-10-14,"PHI","DET",23,26,-3,"2012"
"3280","2012_06_GB_HOU",2012-10-14,"HOU","GB",24,42,-18,"2012"
"3281","2012_06_IND_NYJ",2012-10-14,"NYJ","IND",35,9,26,"2012"
"3282","2012_06_KC_TB",2012-10-14,"TB","KC",38,10,28,"2012"
"3283","2012_06_MIN_WAS",2012-10-14,"WAS","MIN",38,26,12,"2012"
"3284","2012_06_NE_SEA",2012-10-14,"SEA","NE",24,23,1,"2012"
"3285","2012_06_NYG_SF",2012-10-14,"SF","NYG",3,26,-23,"2012"
"3286","2012_06_OAK_ATL",2012-10-14,"ATL","LV",23,20,3,"2012"
"3287","2012_06_PIT_TEN",2012-10-11,"TEN","PIT",26,23,3,"2012"
"3288","2012_06_STL_MIA",2012-10-14,"MIA","LA",17,14,3,"2012"
"3289","2012_07_ARI_MIN",2012-10-21,"MIN","ARI",21,14,7,"2012"
"3290","2012_07_BAL_HOU",2012-10-21,"HOU","BAL",43,13,30,"2012"
"3291","2012_07_CLE_IND",2012-10-21,"IND","CLE",17,13,4,"2012"
"3292","2012_07_DAL_CAR",2012-10-21,"CAR","DAL",14,19,-5,"2012"
"3293","2012_07_DET_CHI",2012-10-22,"CHI","DET",13,7,6,"2012"
"3294","2012_07_GB_STL",2012-10-21,"LA","GB",20,30,-10,"2012"
"3295","2012_07_JAX_OAK",2012-10-21,"LV","JAX",26,23,3,"2012"
"3296","2012_07_NO_TB",2012-10-21,"TB","NO",28,35,-7,"2012"
"3297","2012_07_NYJ_NE",2012-10-21,"NE","NYJ",29,26,3,"2012"
"3298","2012_07_PIT_CIN",2012-10-21,"CIN","PIT",17,24,-7,"2012"
"3299","2012_07_SEA_SF",2012-10-18,"SF","SEA",13,6,7,"2012"
"3300","2012_07_TEN_BUF",2012-10-21,"BUF","TEN",34,35,-1,"2012"
"3301","2012_07_WAS_NYG",2012-10-21,"NYG","WAS",27,23,4,"2012"
"3302","2012_08_ATL_PHI",2012-10-28,"PHI","ATL",17,30,-13,"2012"
"3303","2012_08_CAR_CHI",2012-10-28,"CHI","CAR",23,22,1,"2012"
"3304","2012_08_IND_TEN",2012-10-28,"TEN","IND",13,19,-6,"2012"
"3305","2012_08_JAX_GB",2012-10-28,"GB","JAX",24,15,9,"2012"
"3306","2012_08_MIA_NYJ",2012-10-28,"NYJ","MIA",9,30,-21,"2012"
"3307","2012_08_NE_STL",2012-10-28,"LA","NE",7,45,-38,"2012"
"3308","2012_08_NO_DEN",2012-10-28,"DEN","NO",34,14,20,"2012"
"3309","2012_08_NYG_DAL",2012-10-28,"DAL","NYG",24,29,-5,"2012"
"3310","2012_08_OAK_KC",2012-10-28,"KC","LV",16,26,-10,"2012"
"3311","2012_08_SD_CLE",2012-10-28,"CLE","LAC",7,6,1,"2012"
"3312","2012_08_SEA_DET",2012-10-28,"DET","SEA",28,24,4,"2012"
"3313","2012_08_SF_ARI",2012-10-29,"ARI","SF",3,24,-21,"2012"
"3314","2012_08_TB_MIN",2012-10-25,"MIN","TB",17,36,-19,"2012"
"3315","2012_08_WAS_PIT",2012-10-28,"PIT","WAS",27,12,15,"2012"
"3316","2012_09_ARI_GB",2012-11-04,"GB","ARI",31,17,14,"2012"
"3317","2012_09_BAL_CLE",2012-11-04,"CLE","BAL",15,25,-10,"2012"
"3318","2012_09_BUF_HOU",2012-11-04,"HOU","BUF",21,9,12,"2012"
"3319","2012_09_CAR_WAS",2012-11-04,"WAS","CAR",13,21,-8,"2012"
"3320","2012_09_CHI_TEN",2012-11-04,"TEN","CHI",20,51,-31,"2012"
"3321","2012_09_DAL_ATL",2012-11-04,"ATL","DAL",19,13,6,"2012"
"3322","2012_09_DEN_CIN",2012-11-04,"CIN","DEN",23,31,-8,"2012"
"3323","2012_09_DET_JAX",2012-11-04,"JAX","DET",14,31,-17,"2012"
"3324","2012_09_KC_SD",2012-11-01,"LAC","KC",31,13,18,"2012"
"3325","2012_09_MIA_IND",2012-11-04,"IND","MIA",23,20,3,"2012"
"3326","2012_09_MIN_SEA",2012-11-04,"SEA","MIN",30,20,10,"2012"
"3327","2012_09_PHI_NO",2012-11-05,"NO","PHI",28,13,15,"2012"
"3328","2012_09_PIT_NYG",2012-11-04,"NYG","PIT",20,24,-4,"2012"
"3329","2012_09_TB_OAK",2012-11-04,"LV","TB",32,42,-10,"2012"
"3330","2012_10_ATL_NO",2012-11-11,"NO","ATL",31,27,4,"2012"
"3331","2012_10_BUF_NE",2012-11-11,"NE","BUF",37,31,6,"2012"
"3332","2012_10_DAL_PHI",2012-11-11,"PHI","DAL",23,38,-15,"2012"
"3333","2012_10_DEN_CAR",2012-11-11,"CAR","DEN",14,36,-22,"2012"
"3334","2012_10_DET_MIN",2012-11-11,"MIN","DET",34,24,10,"2012"
"3335","2012_10_HOU_CHI",2012-11-11,"CHI","HOU",6,13,-7,"2012"
"3336","2012_10_IND_JAX",2012-11-08,"JAX","IND",10,27,-17,"2012"
"3337","2012_10_KC_PIT",2012-11-12,"PIT","KC",16,13,3,"2012"
"3338","2012_10_NYG_CIN",2012-11-11,"CIN","NYG",31,13,18,"2012"
"3339","2012_10_NYJ_SEA",2012-11-11,"SEA","NYJ",28,7,21,"2012"
"3340","2012_10_OAK_BAL",2012-11-11,"BAL","LV",55,20,35,"2012"
"3341","2012_10_SD_TB",2012-11-11,"TB","LAC",34,24,10,"2012"
"3342","2012_10_STL_SF",2012-11-11,"SF","LA",24,24,0,"2012"
"3343","2012_10_TEN_MIA",2012-11-11,"MIA","TEN",3,37,-34,"2012"
"3344","2012_11_ARI_ATL",2012-11-18,"ATL","ARI",23,19,4,"2012"
"3345","2012_11_BAL_PIT",2012-11-18,"PIT","BAL",10,13,-3,"2012"
"3346","2012_11_CHI_SF",2012-11-19,"SF","CHI",32,7,25,"2012"
"3347","2012_11_CIN_KC",2012-11-18,"KC","CIN",6,28,-22,"2012"
"3348","2012_11_CLE_DAL",2012-11-18,"DAL","CLE",23,20,3,"2012"
"3349","2012_11_GB_DET",2012-11-18,"DET","GB",20,24,-4,"2012"
"3350","2012_11_IND_NE",2012-11-18,"NE","IND",59,24,35,"2012"
"3351","2012_11_JAX_HOU",2012-11-18,"HOU","JAX",43,37,6,"2012"
"3352","2012_11_MIA_BUF",2012-11-15,"BUF","MIA",19,14,5,"2012"
"3353","2012_11_NO_OAK",2012-11-18,"LV","NO",17,38,-21,"2012"
"3354","2012_11_NYJ_STL",2012-11-18,"LA","NYJ",13,27,-14,"2012"
"3355","2012_11_PHI_WAS",2012-11-18,"WAS","PHI",31,6,25,"2012"
"3356","2012_11_SD_DEN",2012-11-18,"DEN","LAC",30,23,7,"2012"
"3357","2012_11_TB_CAR",2012-11-18,"CAR","TB",21,27,-6,"2012"
"3358","2012_12_ATL_TB",2012-11-25,"TB","ATL",23,24,-1,"2012"
"3359","2012_12_BAL_SD",2012-11-25,"LAC","BAL",13,16,-3,"2012"
"3360","2012_12_BUF_IND",2012-11-25,"IND","BUF",20,13,7,"2012"
"3361","2012_12_CAR_PHI",2012-11-26,"PHI","CAR",22,30,-8,"2012"
"3362","2012_12_DEN_KC",2012-11-25,"KC","DEN",9,17,-8,"2012"
"3363","2012_12_GB_NYG",2012-11-25,"NYG","GB",38,10,28,"2012"
"3364","2012_12_HOU_DET",2012-11-22,"DET","HOU",31,34,-3,"2012"
"3365","2012_12_MIN_CHI",2012-11-25,"CHI","MIN",28,10,18,"2012"
"3366","2012_12_NE_NYJ",2012-11-22,"NYJ","NE",19,49,-30,"2012"
"3367","2012_12_OAK_CIN",2012-11-25,"CIN","LV",34,10,24,"2012"
"3368","2012_12_PIT_CLE",2012-11-25,"CLE","PIT",20,14,6,"2012"
"3369","2012_12_SEA_MIA",2012-11-25,"MIA","SEA",24,21,3,"2012"
"3370","2012_12_SF_NO",2012-11-25,"NO","SF",21,31,-10,"2012"
"3371","2012_12_STL_ARI",2012-11-25,"ARI","LA",17,31,-14,"2012"
"3372","2012_12_TEN_JAX",2012-11-25,"JAX","TEN",24,19,5,"2012"
"3373","2012_12_WAS_DAL",2012-11-22,"DAL","WAS",31,38,-7,"2012"
"3374","2012_13_ARI_NYJ",2012-12-02,"NYJ","ARI",7,6,1,"2012"
"3375","2012_13_CAR_KC",2012-12-02,"KC","CAR",27,21,6,"2012"
"3376","2012_13_CIN_SD",2012-12-02,"LAC","CIN",13,20,-7,"2012"
"3377","2012_13_CLE_OAK",2012-12-02,"LV","CLE",17,20,-3,"2012"
"3378","2012_13_HOU_TEN",2012-12-02,"TEN","HOU",10,24,-14,"2012"
"3379","2012_13_IND_DET",2012-12-02,"DET","IND",33,35,-2,"2012"
"3380","2012_13_JAX_BUF",2012-12-02,"BUF","JAX",34,18,16,"2012"
"3381","2012_13_MIN_GB",2012-12-02,"GB","MIN",23,14,9,"2012"
"3382","2012_13_NE_MIA",2012-12-02,"MIA","NE",16,23,-7,"2012"
"3383","2012_13_NO_ATL",2012-11-29,"ATL","NO",23,13,10,"2012"
"3384","2012_13_NYG_WAS",2012-12-03,"WAS","NYG",17,16,1,"2012"
"3385","2012_13_PHI_DAL",2012-12-02,"DAL","PHI",38,33,5,"2012"
"3386","2012_13_PIT_BAL",2012-12-02,"BAL","PIT",20,23,-3,"2012"
"3387","2012_13_SEA_CHI",2012-12-02,"CHI","SEA",17,23,-6,"2012"
"3388","2012_13_SF_STL",2012-12-02,"LA","SF",16,13,3,"2012"
"3389","2012_13_TB_DEN",2012-12-02,"DEN","TB",31,23,8,"2012"
"3390","2012_14_ARI_SEA",2012-12-09,"SEA","ARI",58,0,58,"2012"
"3391","2012_14_ATL_CAR",2012-12-09,"CAR","ATL",30,20,10,"2012"
"3392","2012_14_BAL_WAS",2012-12-09,"WAS","BAL",31,28,3,"2012"
"3393","2012_14_CHI_MIN",2012-12-09,"MIN","CHI",21,14,7,"2012"
"3394","2012_14_DAL_CIN",2012-12-09,"CIN","DAL",19,20,-1,"2012"
"3395","2012_14_DEN_OAK",2012-12-06,"LV","DEN",13,26,-13,"2012"
"3396","2012_14_DET_GB",2012-12-09,"GB","DET",27,20,7,"2012"
"3397","2012_14_HOU_NE",2012-12-10,"NE","HOU",42,14,28,"2012"
"3398","2012_14_KC_CLE",2012-12-09,"CLE","KC",30,7,23,"2012"
"3399","2012_14_MIA_SF",2012-12-09,"SF","MIA",27,13,14,"2012"
"3400","2012_14_NO_NYG",2012-12-09,"NYG","NO",52,27,25,"2012"
"3401","2012_14_NYJ_JAX",2012-12-09,"JAX","NYJ",10,17,-7,"2012"
"3402","2012_14_PHI_TB",2012-12-09,"TB","PHI",21,23,-2,"2012"
"3403","2012_14_SD_PIT",2012-12-09,"PIT","LAC",24,34,-10,"2012"
"3404","2012_14_STL_BUF",2012-12-09,"BUF","LA",12,15,-3,"2012"
"3405","2012_14_TEN_IND",2012-12-09,"IND","TEN",27,23,4,"2012"
"3406","2012_15_CAR_SD",2012-12-16,"LAC","CAR",7,31,-24,"2012"
"3407","2012_15_CIN_PHI",2012-12-13,"PHI","CIN",13,34,-21,"2012"
"3408","2012_15_DEN_BAL",2012-12-16,"BAL","DEN",17,34,-17,"2012"
"3409","2012_15_DET_ARI",2012-12-16,"ARI","DET",38,10,28,"2012"
"3410","2012_15_GB_CHI",2012-12-16,"CHI","GB",13,21,-8,"2012"
"3411","2012_15_IND_HOU",2012-12-16,"HOU","IND",29,17,12,"2012"
"3412","2012_15_JAX_MIA",2012-12-16,"MIA","JAX",24,3,21,"2012"
"3413","2012_15_KC_OAK",2012-12-16,"LV","KC",15,0,15,"2012"
"3414","2012_15_MIN_STL",2012-12-16,"LA","MIN",22,36,-14,"2012"
"3415","2012_15_NYG_ATL",2012-12-16,"ATL","NYG",34,0,34,"2012"
"3416","2012_15_NYJ_TEN",2012-12-17,"TEN","NYJ",14,10,4,"2012"
"3417","2012_15_PIT_DAL",2012-12-16,"DAL","PIT",27,24,3,"2012"
"3418","2012_15_SEA_BUF",2012-12-16,"BUF","SEA",17,50,-33,"2012"
"3419","2012_15_SF_NE",2012-12-16,"NE","SF",34,41,-7,"2012"
"3420","2012_15_TB_NO",2012-12-16,"NO","TB",41,0,41,"2012"
"3421","2012_15_WAS_CLE",2012-12-16,"CLE","WAS",21,38,-17,"2012"
"3422","2012_16_ATL_DET",2012-12-22,"DET","ATL",18,31,-13,"2012"
"3423","2012_16_BUF_MIA",2012-12-23,"MIA","BUF",24,10,14,"2012"
"3424","2012_16_CHI_ARI",2012-12-23,"ARI","CHI",13,28,-15,"2012"
"3425","2012_16_CIN_PIT",2012-12-23,"PIT","CIN",10,13,-3,"2012"
"3426","2012_16_CLE_DEN",2012-12-23,"DEN","CLE",34,12,22,"2012"
"3427","2012_16_IND_KC",2012-12-23,"KC","IND",13,20,-7,"2012"
"3428","2012_16_MIN_HOU",2012-12-23,"HOU","MIN",6,23,-17,"2012"
"3429","2012_16_NE_JAX",2012-12-23,"JAX","NE",16,23,-7,"2012"
"3430","2012_16_NO_DAL",2012-12-23,"DAL","NO",31,34,-3,"2012"
"3431","2012_16_NYG_BAL",2012-12-23,"BAL","NYG",33,14,19,"2012"
"3432","2012_16_OAK_CAR",2012-12-23,"CAR","LV",17,6,11,"2012"
"3433","2012_16_SD_NYJ",2012-12-23,"NYJ","LAC",17,27,-10,"2012"
"3434","2012_16_SF_SEA",2012-12-23,"SEA","SF",42,13,29,"2012"
"3435","2012_16_STL_TB",2012-12-23,"TB","LA",13,28,-15,"2012"
"3436","2012_16_TEN_GB",2012-12-23,"GB","TEN",55,7,48,"2012"
"3437","2012_16_WAS_PHI",2012-12-23,"PHI","WAS",20,27,-7,"2012"
"3438","2012_17_ARI_SF",2012-12-30,"SF","ARI",27,13,14,"2012"
"3439","2012_17_BAL_CIN",2012-12-30,"CIN","BAL",23,17,6,"2012"
"3440","2012_17_CAR_NO",2012-12-30,"NO","CAR",38,44,-6,"2012"
"3441","2012_17_CHI_DET",2012-12-30,"DET","CHI",24,26,-2,"2012"
"3442","2012_17_CLE_PIT",2012-12-30,"PIT","CLE",24,10,14,"2012"
"3443","2012_17_DAL_WAS",2012-12-30,"WAS","DAL",28,18,10,"2012"
"3444","2012_17_GB_MIN",2012-12-30,"MIN","GB",37,34,3,"2012"
"3445","2012_17_HOU_IND",2012-12-30,"IND","HOU",28,16,12,"2012"
"3446","2012_17_JAX_TEN",2012-12-30,"TEN","JAX",38,20,18,"2012"
"3447","2012_17_KC_DEN",2012-12-30,"DEN","KC",38,3,35,"2012"
"3448","2012_17_MIA_NE",2012-12-30,"NE","MIA",28,0,28,"2012"
"3449","2012_17_NYJ_BUF",2012-12-30,"BUF","NYJ",28,9,19,"2012"
"3450","2012_17_OAK_SD",2012-12-30,"LAC","LV",24,21,3,"2012"
"3451","2012_17_PHI_NYG",2012-12-30,"NYG","PHI",42,7,35,"2012"
"3452","2012_17_STL_SEA",2012-12-30,"SEA","LA",20,13,7,"2012"
"3453","2012_17_TB_ATL",2012-12-30,"ATL","TB",17,22,-5,"2012"
"3454","2013_01_ARI_STL",2013-09-08,"LA","ARI",27,24,3,"2013"
"3455","2013_01_ATL_NO",2013-09-08,"NO","ATL",23,17,6,"2013"
"3456","2013_01_BAL_DEN",2013-09-05,"DEN","BAL",49,27,22,"2013"
"3457","2013_01_CIN_CHI",2013-09-08,"CHI","CIN",24,21,3,"2013"
"3458","2013_01_GB_SF",2013-09-08,"SF","GB",34,28,6,"2013"
"3459","2013_01_HOU_SD",2013-09-09,"LAC","HOU",28,31,-3,"2013"
"3460","2013_01_KC_JAX",2013-09-08,"JAX","KC",2,28,-26,"2013"
"3461","2013_01_MIA_CLE",2013-09-08,"CLE","MIA",10,23,-13,"2013"
"3462","2013_01_MIN_DET",2013-09-08,"DET","MIN",34,24,10,"2013"
"3463","2013_01_NE_BUF",2013-09-08,"BUF","NE",21,23,-2,"2013"
"3464","2013_01_NYG_DAL",2013-09-08,"DAL","NYG",36,31,5,"2013"
"3465","2013_01_OAK_IND",2013-09-08,"IND","LV",21,17,4,"2013"
"3466","2013_01_PHI_WAS",2013-09-09,"WAS","PHI",27,33,-6,"2013"
"3467","2013_01_SEA_CAR",2013-09-08,"CAR","SEA",7,12,-5,"2013"
"3468","2013_01_TB_NYJ",2013-09-08,"NYJ","TB",18,17,1,"2013"
"3469","2013_01_TEN_PIT",2013-09-08,"PIT","TEN",9,16,-7,"2013"
"3470","2013_02_CAR_BUF",2013-09-15,"BUF","CAR",24,23,1,"2013"
"3471","2013_02_CLE_BAL",2013-09-15,"BAL","CLE",14,6,8,"2013"
"3472","2013_02_DAL_KC",2013-09-15,"KC","DAL",17,16,1,"2013"
"3473","2013_02_DEN_NYG",2013-09-15,"NYG","DEN",23,41,-18,"2013"
"3474","2013_02_DET_ARI",2013-09-15,"ARI","DET",25,21,4,"2013"
"3475","2013_02_JAX_OAK",2013-09-15,"LV","JAX",19,9,10,"2013"
"3476","2013_02_MIA_IND",2013-09-15,"IND","MIA",20,24,-4,"2013"
"3477","2013_02_MIN_CHI",2013-09-15,"CHI","MIN",31,30,1,"2013"
"3478","2013_02_NO_TB",2013-09-15,"TB","NO",14,16,-2,"2013"
"3479","2013_02_NYJ_NE",2013-09-12,"NE","NYJ",13,10,3,"2013"
"3480","2013_02_PIT_CIN",2013-09-16,"CIN","PIT",20,10,10,"2013"
"3481","2013_02_SD_PHI",2013-09-15,"PHI","LAC",30,33,-3,"2013"
"3482","2013_02_SF_SEA",2013-09-15,"SEA","SF",29,3,26,"2013"
"3483","2013_02_STL_ATL",2013-09-15,"ATL","LA",31,24,7,"2013"
"3484","2013_02_TEN_HOU",2013-09-15,"HOU","TEN",30,24,6,"2013"
"3485","2013_02_WAS_GB",2013-09-15,"GB","WAS",38,20,18,"2013"
"3486","2013_03_ARI_NO",2013-09-22,"NO","ARI",31,7,24,"2013"
"3487","2013_03_ATL_MIA",2013-09-22,"MIA","ATL",27,23,4,"2013"
"3488","2013_03_BUF_NYJ",2013-09-22,"NYJ","BUF",27,20,7,"2013"
"3489","2013_03_CHI_PIT",2013-09-22,"PIT","CHI",23,40,-17,"2013"
"3490","2013_03_CLE_MIN",2013-09-22,"MIN","CLE",27,31,-4,"2013"
"3491","2013_03_DET_WAS",2013-09-22,"WAS","DET",20,27,-7,"2013"
"3492","2013_03_GB_CIN",2013-09-22,"CIN","GB",34,30,4,"2013"
"3493","2013_03_HOU_BAL",2013-09-22,"BAL","HOU",30,9,21,"2013"
"3494","2013_03_IND_SF",2013-09-22,"SF","IND",7,27,-20,"2013"
"3495","2013_03_JAX_SEA",2013-09-22,"SEA","JAX",45,17,28,"2013"
"3496","2013_03_KC_PHI",2013-09-19,"PHI","KC",16,26,-10,"2013"
"3497","2013_03_NYG_CAR",2013-09-22,"CAR","NYG",38,0,38,"2013"
"3498","2013_03_OAK_DEN",2013-09-23,"DEN","LV",37,21,16,"2013"
"3499","2013_03_SD_TEN",2013-09-22,"TEN","LAC",20,17,3,"2013"
"3500","2013_03_STL_DAL",2013-09-22,"DAL","LA",31,7,24,"2013"
"3501","2013_03_TB_NE",2013-09-22,"NE","TB",23,3,20,"2013"
"3502","2013_04_ARI_TB",2013-09-29,"TB","ARI",10,13,-3,"2013"
"3503","2013_04_BAL_BUF",2013-09-29,"BUF","BAL",23,20,3,"2013"
"3504","2013_04_CHI_DET",2013-09-29,"DET","CHI",40,32,8,"2013"
"3505","2013_04_CIN_CLE",2013-09-29,"CLE","CIN",17,6,11,"2013"
"3506","2013_04_DAL_SD",2013-09-29,"LAC","DAL",30,21,9,"2013"
"3507","2013_04_IND_JAX",2013-09-29,"JAX","IND",3,37,-34,"2013"
"3508","2013_04_MIA_NO",2013-09-30,"NO","MIA",38,17,21,"2013"
"3509","2013_04_NE_ATL",2013-09-29,"ATL","NE",23,30,-7,"2013"
"3510","2013_04_NYG_KC",2013-09-29,"KC","NYG",31,7,24,"2013"
"3511","2013_04_NYJ_TEN",2013-09-29,"TEN","NYJ",38,13,25,"2013"
"3512","2013_04_PHI_DEN",2013-09-29,"DEN","PHI",52,20,32,"2013"
"3513","2013_04_PIT_MIN",2013-09-29,"MIN","PIT",34,27,7,"2013"
"3514","2013_04_SEA_HOU",2013-09-29,"HOU","SEA",20,23,-3,"2013"
"3515","2013_04_SF_STL",2013-09-26,"LA","SF",11,35,-24,"2013"
"3516","2013_04_WAS_OAK",2013-09-29,"LV","WAS",14,24,-10,"2013"
"3517","2013_05_BAL_MIA",2013-10-06,"MIA","BAL",23,26,-3,"2013"
"3518","2013_05_BUF_CLE",2013-10-03,"CLE","BUF",37,24,13,"2013"
"3519","2013_05_CAR_ARI",2013-10-06,"ARI","CAR",22,6,16,"2013"
"3520","2013_05_DEN_DAL",2013-10-06,"DAL","DEN",48,51,-3,"2013"
"3521","2013_05_DET_GB",2013-10-06,"GB","DET",22,9,13,"2013"
"3522","2013_05_HOU_SF",2013-10-06,"SF","HOU",34,3,31,"2013"
"3523","2013_05_JAX_STL",2013-10-06,"LA","JAX",34,20,14,"2013"
"3524","2013_05_KC_TEN",2013-10-06,"TEN","KC",17,26,-9,"2013"
"3525","2013_05_NE_CIN",2013-10-06,"CIN","NE",13,6,7,"2013"
"3526","2013_05_NO_CHI",2013-10-06,"CHI","NO",18,26,-8,"2013"
"3527","2013_05_NYJ_ATL",2013-10-07,"ATL","NYJ",28,30,-2,"2013"
"3528","2013_05_PHI_NYG",2013-10-06,"NYG","PHI",21,36,-15,"2013"
"3529","2013_05_SD_OAK",2013-10-06,"LV","LAC",27,17,10,"2013"
"3530","2013_05_SEA_IND",2013-10-06,"IND","SEA",34,28,6,"2013"
"3531","2013_06_ARI_SF",2013-10-13,"SF","ARI",32,20,12,"2013"
"3532","2013_06_CAR_MIN",2013-10-13,"MIN","CAR",10,35,-25,"2013"
"3533","2013_06_CIN_BUF",2013-10-13,"BUF","CIN",24,27,-3,"2013"
"3534","2013_06_DET_CLE",2013-10-13,"CLE","DET",17,31,-14,"2013"
"3535","2013_06_GB_BAL",2013-10-13,"BAL","GB",17,19,-2,"2013"
"3536","2013_06_IND_SD",2013-10-14,"LAC","IND",19,9,10,"2013"
"3537","2013_06_JAX_DEN",2013-10-13,"DEN","JAX",35,19,16,"2013"
"3538","2013_06_NO_NE",2013-10-13,"NE","NO",30,27,3,"2013"
"3539","2013_06_NYG_CHI",2013-10-10,"CHI","NYG",27,21,6,"2013"
"3540","2013_06_OAK_KC",2013-10-13,"KC","LV",24,7,17,"2013"
"3541","2013_06_PHI_TB",2013-10-13,"TB","PHI",20,31,-11,"2013"
"3542","2013_06_PIT_NYJ",2013-10-13,"NYJ","PIT",6,19,-13,"2013"
"3543","2013_06_STL_HOU",2013-10-13,"HOU","LA",13,38,-25,"2013"
"3544","2013_06_TEN_SEA",2013-10-13,"SEA","TEN",20,13,7,"2013"
"3545","2013_06_WAS_DAL",2013-10-13,"DAL","WAS",31,16,15,"2013"
"3546","2013_07_BAL_PIT",2013-10-20,"PIT","BAL",19,16,3,"2013"
"3547","2013_07_BUF_MIA",2013-10-20,"MIA","BUF",21,23,-2,"2013"
"3548","2013_07_CHI_WAS",2013-10-20,"WAS","CHI",45,41,4,"2013"
"3549","2013_07_CIN_DET",2013-10-20,"DET","CIN",24,27,-3,"2013"
"3550","2013_07_CLE_GB",2013-10-20,"GB","CLE",31,13,18,"2013"
"3551","2013_07_DAL_PHI",2013-10-20,"PHI","DAL",3,17,-14,"2013"
"3552","2013_07_DEN_IND",2013-10-20,"IND","DEN",39,33,6,"2013"
"3553","2013_07_HOU_KC",2013-10-20,"KC","HOU",17,16,1,"2013"
"3554","2013_07_MIN_NYG",2013-10-21,"NYG","MIN",23,7,16,"2013"
"3555","2013_07_NE_NYJ",2013-10-20,"NYJ","NE",30,27,3,"2013"
"3556","2013_07_SD_JAX",2013-10-20,"JAX","LAC",6,24,-18,"2013"
"3557","2013_07_SEA_ARI",2013-10-17,"ARI","SEA",22,34,-12,"2013"
"3558","2013_07_SF_TEN",2013-10-20,"TEN","SF",17,31,-14,"2013"
"3559","2013_07_STL_CAR",2013-10-20,"CAR","LA",30,15,15,"2013"
"3560","2013_07_TB_ATL",2013-10-20,"ATL","TB",31,23,8,"2013"
"3561","2013_08_ATL_ARI",2013-10-27,"ARI","ATL",27,13,14,"2013"
"3562","2013_08_BUF_NO",2013-10-27,"NO","BUF",35,17,18,"2013"
"3563","2013_08_CAR_TB",2013-10-24,"TB","CAR",13,31,-18,"2013"
"3564","2013_08_CLE_KC",2013-10-27,"KC","CLE",23,17,6,"2013"
"3565","2013_08_DAL_DET",2013-10-27,"DET","DAL",31,30,1,"2013"
"3566","2013_08_GB_MIN",2013-10-27,"MIN","GB",31,44,-13,"2013"
"3567","2013_08_MIA_NE",2013-10-27,"NE","MIA",27,17,10,"2013"
"3568","2013_08_NYG_PHI",2013-10-27,"PHI","NYG",7,15,-8,"2013"
"3569","2013_08_NYJ_CIN",2013-10-27,"CIN","NYJ",49,9,40,"2013"
"3570","2013_08_PIT_OAK",2013-10-27,"LV","PIT",21,18,3,"2013"
"3571","2013_08_SEA_STL",2013-10-28,"LA","SEA",9,14,-5,"2013"
"3572","2013_08_SF_JAX",2013-10-27,"JAX","SF",10,42,-32,"2013"
"3573","2013_08_WAS_DEN",2013-10-27,"DEN","WAS",45,21,24,"2013"
"3574","2013_09_ATL_CAR",2013-11-03,"CAR","ATL",34,10,24,"2013"
"3575","2013_09_BAL_CLE",2013-11-03,"CLE","BAL",24,18,6,"2013"
"3576","2013_09_CHI_GB",2013-11-04,"GB","CHI",20,27,-7,"2013"
"3577","2013_09_CIN_MIA",2013-10-31,"MIA","CIN",22,20,2,"2013"
"3578","2013_09_IND_HOU",2013-11-03,"HOU","IND",24,27,-3,"2013"
"3579","2013_09_KC_BUF",2013-11-03,"BUF","KC",13,23,-10,"2013"
"3580","2013_09_MIN_DAL",2013-11-03,"DAL","MIN",27,23,4,"2013"
"3581","2013_09_NO_NYJ",2013-11-03,"NYJ","NO",26,20,6,"2013"
"3582","2013_09_PHI_OAK",2013-11-03,"LV","PHI",20,49,-29,"2013"
"3583","2013_09_PIT_NE",2013-11-03,"NE","PIT",55,31,24,"2013"
"3584","2013_09_SD_WAS",2013-11-03,"WAS","LAC",30,24,6,"2013"
"3585","2013_09_TB_SEA",2013-11-03,"SEA","TB",27,24,3,"2013"
"3586","2013_09_TEN_STL",2013-11-03,"LA","TEN",21,28,-7,"2013"
"3587","2013_10_BUF_PIT",2013-11-10,"PIT","BUF",23,10,13,"2013"
"3588","2013_10_CAR_SF",2013-11-10,"SF","CAR",9,10,-1,"2013"
"3589","2013_10_CIN_BAL",2013-11-10,"BAL","CIN",20,17,3,"2013"
"3590","2013_10_DAL_NO",2013-11-10,"NO","DAL",49,17,32,"2013"
"3591","2013_10_DEN_SD",2013-11-10,"LAC","DEN",20,28,-8,"2013"
"3592","2013_10_DET_CHI",2013-11-10,"CHI","DET",19,21,-2,"2013"
"3593","2013_10_HOU_ARI",2013-11-10,"ARI","HOU",27,24,3,"2013"
"3594","2013_10_JAX_TEN",2013-11-10,"TEN","JAX",27,29,-2,"2013"
"3595","2013_10_MIA_TB",2013-11-11,"TB","MIA",22,19,3,"2013"
"3596","2013_10_OAK_NYG",2013-11-10,"NYG","LV",24,20,4,"2013"
"3597","2013_10_PHI_GB",2013-11-10,"GB","PHI",13,27,-14,"2013"
"3598","2013_10_SEA_ATL",2013-11-10,"ATL","SEA",10,33,-23,"2013"
"3599","2013_10_STL_IND",2013-11-10,"IND","LA",8,38,-30,"2013"
"3600","2013_10_WAS_MIN",2013-11-07,"MIN","WAS",34,27,7,"2013"
"3601","2013_11_ARI_JAX",2013-11-17,"JAX","ARI",14,27,-13,"2013"
"3602","2013_11_ATL_TB",2013-11-17,"TB","ATL",41,28,13,"2013"
"3603","2013_11_BAL_CHI",2013-11-17,"CHI","BAL",23,20,3,"2013"
"3604","2013_11_CLE_CIN",2013-11-17,"CIN","CLE",41,20,21,"2013"
"3605","2013_11_DET_PIT",2013-11-17,"PIT","DET",37,27,10,"2013"
"3606","2013_11_GB_NYG",2013-11-17,"NYG","GB",27,13,14,"2013"
"3607","2013_11_IND_TEN",2013-11-14,"TEN","IND",27,30,-3,"2013"
"3608","2013_11_KC_DEN",2013-11-17,"DEN","KC",27,17,10,"2013"
"3609","2013_11_MIN_SEA",2013-11-17,"SEA","MIN",41,20,21,"2013"
"3610","2013_11_NE_CAR",2013-11-18,"CAR","NE",24,20,4,"2013"
"3611","2013_11_NYJ_BUF",2013-11-17,"BUF","NYJ",37,14,23,"2013"
"3612","2013_11_OAK_HOU",2013-11-17,"HOU","LV",23,28,-5,"2013"
"3613","2013_11_SD_MIA",2013-11-17,"MIA","LAC",20,16,4,"2013"
"3614","2013_11_SF_NO",2013-11-17,"NO","SF",23,20,3,"2013"
"3615","2013_11_WAS_PHI",2013-11-17,"PHI","WAS",24,16,8,"2013"
"3616","2013_12_CAR_MIA",2013-11-24,"MIA","CAR",16,20,-4,"2013"
"3617","2013_12_CHI_STL",2013-11-24,"LA","CHI",42,21,21,"2013"
"3618","2013_12_DAL_NYG",2013-11-24,"NYG","DAL",21,24,-3,"2013"
"3619","2013_12_DEN_NE",2013-11-24,"NE","DEN",34,31,3,"2013"
"3620","2013_12_IND_ARI",2013-11-24,"ARI","IND",40,11,29,"2013"
"3621","2013_12_JAX_HOU",2013-11-24,"HOU","JAX",6,13,-7,"2013"
"3622","2013_12_MIN_GB",2013-11-24,"GB","MIN",26,26,0,"2013"
"3623","2013_12_NO_ATL",2013-11-21,"ATL","NO",13,17,-4,"2013"
"3624","2013_12_NYJ_BAL",2013-11-24,"BAL","NYJ",19,3,16,"2013"
"3625","2013_12_PIT_CLE",2013-11-24,"CLE","PIT",11,27,-16,"2013"
"3626","2013_12_SD_KC",2013-11-24,"KC","LAC",38,41,-3,"2013"
"3627","2013_12_SF_WAS",2013-11-25,"WAS","SF",6,27,-21,"2013"
"3628","2013_12_TB_DET",2013-11-24,"DET","TB",21,24,-3,"2013"
"3629","2013_12_TEN_OAK",2013-11-24,"LV","TEN",19,23,-4,"2013"
"3630","2013_13_ARI_PHI",2013-12-01,"PHI","ARI",24,21,3,"2013"
"3631","2013_13_ATL_BUF",2013-12-01,"BUF","ATL",31,34,-3,"2013"
"3632","2013_13_CHI_MIN",2013-12-01,"MIN","CHI",23,20,3,"2013"
"3633","2013_13_CIN_SD",2013-12-01,"LAC","CIN",10,17,-7,"2013"
"3634","2013_13_DEN_KC",2013-12-01,"KC","DEN",28,35,-7,"2013"
"3635","2013_13_GB_DET",2013-11-28,"DET","GB",40,10,30,"2013"
"3636","2013_13_JAX_CLE",2013-12-01,"CLE","JAX",28,32,-4,"2013"
"3637","2013_13_MIA_NYJ",2013-12-01,"NYJ","MIA",3,23,-20,"2013"
"3638","2013_13_NE_HOU",2013-12-01,"HOU","NE",31,34,-3,"2013"
"3639","2013_13_NO_SEA",2013-12-02,"SEA","NO",34,7,27,"2013"
"3640","2013_13_NYG_WAS",2013-12-01,"WAS","NYG",17,24,-7,"2013"
"3641","2013_13_OAK_DAL",2013-11-28,"DAL","LV",31,24,7,"2013"
"3642","2013_13_PIT_BAL",2013-11-28,"BAL","PIT",22,20,2,"2013"
"3643","2013_13_STL_SF",2013-12-01,"SF","LA",23,13,10,"2013"
"3644","2013_13_TB_CAR",2013-12-01,"CAR","TB",27,6,21,"2013"
"3645","2013_13_TEN_IND",2013-12-01,"IND","TEN",22,14,8,"2013"
"3646","2013_14_ATL_GB",2013-12-08,"GB","ATL",22,21,1,"2013"
"3647","2013_14_BUF_TB",2013-12-08,"TB","BUF",27,6,21,"2013"
"3648","2013_14_CAR_NO",2013-12-08,"NO","CAR",31,13,18,"2013"
"3649","2013_14_CLE_NE",2013-12-08,"NE","CLE",27,26,1,"2013"
"3650","2013_14_DAL_CHI",2013-12-09,"CHI","DAL",45,28,17,"2013"
"3651","2013_14_DET_PHI",2013-12-08,"PHI","DET",34,20,14,"2013"
"3652","2013_14_HOU_JAX",2013-12-05,"JAX","HOU",27,20,7,"2013"
"3653","2013_14_IND_CIN",2013-12-08,"CIN","IND",42,28,14,"2013"
"3654","2013_14_KC_WAS",2013-12-08,"WAS","KC",10,45,-35,"2013"
"3655","2013_14_MIA_PIT",2013-12-08,"PIT","MIA",28,34,-6,"2013"
"3656","2013_14_MIN_BAL",2013-12-08,"BAL","MIN",29,26,3,"2013"
"3657","2013_14_NYG_SD",2013-12-08,"LAC","NYG",37,14,23,"2013"
"3658","2013_14_OAK_NYJ",2013-12-08,"NYJ","LV",37,27,10,"2013"
"3659","2013_14_SEA_SF",2013-12-08,"SF","SEA",19,17,2,"2013"
"3660","2013_14_STL_ARI",2013-12-08,"ARI","LA",30,10,20,"2013"
"3661","2013_14_TEN_DEN",2013-12-08,"DEN","TEN",51,28,23,"2013"
"3662","2013_15_ARI_TEN",2013-12-15,"TEN","ARI",34,37,-3,"2013"
"3663","2013_15_BAL_DET",2013-12-16,"DET","BAL",16,18,-2,"2013"
"3664","2013_15_BUF_JAX",2013-12-15,"JAX","BUF",20,27,-7,"2013"
"3665","2013_15_CHI_CLE",2013-12-15,"CLE","CHI",31,38,-7,"2013"
"3666","2013_15_CIN_PIT",2013-12-15,"PIT","CIN",30,20,10,"2013"
"3667","2013_15_GB_DAL",2013-12-15,"DAL","GB",36,37,-1,"2013"
"3668","2013_15_HOU_IND",2013-12-15,"IND","HOU",25,3,22,"2013"
"3669","2013_15_KC_OAK",2013-12-15,"LV","KC",31,56,-25,"2013"
"3670","2013_15_NE_MIA",2013-12-15,"MIA","NE",24,20,4,"2013"
"3671","2013_15_NO_STL",2013-12-15,"LA","NO",27,16,11,"2013"
"3672","2013_15_NYJ_CAR",2013-12-15,"CAR","NYJ",30,20,10,"2013"
"3673","2013_15_PHI_MIN",2013-12-15,"MIN","PHI",48,30,18,"2013"
"3674","2013_15_SD_DEN",2013-12-12,"DEN","LAC",20,27,-7,"2013"
"3675","2013_15_SEA_NYG",2013-12-15,"NYG","SEA",0,23,-23,"2013"
"3676","2013_15_SF_TB",2013-12-15,"TB","SF",14,33,-19,"2013"
"3677","2013_15_WAS_ATL",2013-12-15,"ATL","WAS",27,26,1,"2013"
"3678","2013_16_ARI_SEA",2013-12-22,"SEA","ARI",10,17,-7,"2013"
"3679","2013_16_ATL_SF",2013-12-23,"SF","ATL",34,24,10,"2013"
"3680","2013_16_CHI_PHI",2013-12-22,"PHI","CHI",54,11,43,"2013"
"3681","2013_16_CLE_NYJ",2013-12-22,"NYJ","CLE",24,13,11,"2013"
"3682","2013_16_DAL_WAS",2013-12-22,"WAS","DAL",23,24,-1,"2013"
"3683","2013_16_DEN_HOU",2013-12-22,"HOU","DEN",13,37,-24,"2013"
"3684","2013_16_IND_KC",2013-12-22,"KC","IND",7,23,-16,"2013"
"3685","2013_16_MIA_BUF",2013-12-22,"BUF","MIA",19,0,19,"2013"
"3686","2013_16_MIN_CIN",2013-12-22,"CIN","MIN",42,14,28,"2013"
"3687","2013_16_NE_BAL",2013-12-22,"BAL","NE",7,41,-34,"2013"
"3688","2013_16_NO_CAR",2013-12-22,"CAR","NO",17,13,4,"2013"
"3689","2013_16_NYG_DET",2013-12-22,"DET","NYG",20,23,-3,"2013"
"3690","2013_16_OAK_SD",2013-12-22,"LAC","LV",26,13,13,"2013"
"3691","2013_16_PIT_GB",2013-12-22,"GB","PIT",31,38,-7,"2013"
"3692","2013_16_TB_STL",2013-12-22,"LA","TB",23,13,10,"2013"
"3693","2013_16_TEN_JAX",2013-12-22,"JAX","TEN",16,20,-4,"2013"
"3694","2013_17_BAL_CIN",2013-12-29,"CIN","BAL",34,17,17,"2013"
"3695","2013_17_BUF_NE",2013-12-29,"NE","BUF",34,20,14,"2013"
"3696","2013_17_CAR_ATL",2013-12-29,"ATL","CAR",20,21,-1,"2013"
"3697","2013_17_CLE_PIT",2013-12-29,"PIT","CLE",20,7,13,"2013"
"3698","2013_17_DEN_OAK",2013-12-29,"LV","DEN",14,34,-20,"2013"
"3699","2013_17_DET_MIN",2013-12-29,"MIN","DET",14,13,1,"2013"
"3700","2013_17_GB_CHI",2013-12-29,"CHI","GB",28,33,-5,"2013"
"3701","2013_17_HOU_TEN",2013-12-29,"TEN","HOU",16,10,6,"2013"
"3702","2013_17_JAX_IND",2013-12-29,"IND","JAX",30,10,20,"2013"
"3703","2013_17_KC_SD",2013-12-29,"LAC","KC",27,24,3,"2013"
"3704","2013_17_NYJ_MIA",2013-12-29,"MIA","NYJ",7,20,-13,"2013"
"3705","2013_17_PHI_DAL",2013-12-29,"DAL","PHI",22,24,-2,"2013"
"3706","2013_17_SF_ARI",2013-12-29,"ARI","SF",20,23,-3,"2013"
"3707","2013_17_STL_SEA",2013-12-29,"SEA","LA",27,9,18,"2013"
"3708","2013_17_TB_NO",2013-12-29,"NO","TB",42,17,25,"2013"
"3709","2013_17_WAS_NYG",2013-12-29,"NYG","WAS",20,6,14,"2013"
"3710","2014_01_BUF_CHI",2014-09-07,"CHI","BUF",20,23,-3,"2014"
"3711","2014_01_CAR_TB",2014-09-07,"TB","CAR",14,20,-6,"2014"
"3712","2014_01_CIN_BAL",2014-09-07,"BAL","CIN",16,23,-7,"2014"
"3713","2014_01_CLE_PIT",2014-09-07,"PIT","CLE",30,27,3,"2014"
"3714","2014_01_GB_SEA",2014-09-04,"SEA","GB",36,16,20,"2014"
"3715","2014_01_IND_DEN",2014-09-07,"DEN","IND",31,24,7,"2014"
"3716","2014_01_JAX_PHI",2014-09-07,"PHI","JAX",34,17,17,"2014"
"3717","2014_01_MIN_STL",2014-09-07,"LA","MIN",6,34,-28,"2014"
"3718","2014_01_NE_MIA",2014-09-07,"MIA","NE",33,20,13,"2014"
"3719","2014_01_NO_ATL",2014-09-07,"ATL","NO",37,34,3,"2014"
"3720","2014_01_NYG_DET",2014-09-08,"DET","NYG",35,14,21,"2014"
"3721","2014_01_OAK_NYJ",2014-09-07,"NYJ","LV",19,14,5,"2014"
"3722","2014_01_SD_ARI",2014-09-08,"ARI","LAC",18,17,1,"2014"
"3723","2014_01_SF_DAL",2014-09-07,"DAL","SF",17,28,-11,"2014"
"3724","2014_01_TEN_KC",2014-09-07,"KC","TEN",10,26,-16,"2014"
"3725","2014_01_WAS_HOU",2014-09-07,"HOU","WAS",17,6,11,"2014"
"3726","2014_02_ARI_NYG",2014-09-14,"NYG","ARI",14,25,-11,"2014"
"3727","2014_02_ATL_CIN",2014-09-14,"CIN","ATL",24,10,14,"2014"
"3728","2014_02_CHI_SF",2014-09-14,"SF","CHI",20,28,-8,"2014"
"3729","2014_02_DAL_TEN",2014-09-14,"TEN","DAL",10,26,-16,"2014"
"3730","2014_02_DET_CAR",2014-09-14,"CAR","DET",24,7,17,"2014"
"3731","2014_02_HOU_OAK",2014-09-14,"LV","HOU",14,30,-16,"2014"
"3732","2014_02_JAX_WAS",2014-09-14,"WAS","JAX",41,10,31,"2014"
"3733","2014_02_KC_DEN",2014-09-14,"DEN","KC",24,17,7,"2014"
"3734","2014_02_MIA_BUF",2014-09-14,"BUF","MIA",29,10,19,"2014"
"3735","2014_02_NE_MIN",2014-09-14,"MIN","NE",7,30,-23,"2014"
"3736","2014_02_NO_CLE",2014-09-14,"CLE","NO",26,24,2,"2014"
"3737","2014_02_NYJ_GB",2014-09-14,"GB","NYJ",31,24,7,"2014"
"3738","2014_02_PHI_IND",2014-09-15,"IND","PHI",27,30,-3,"2014"
"3739","2014_02_PIT_BAL",2014-09-11,"BAL","PIT",26,6,20,"2014"
"3740","2014_02_SEA_SD",2014-09-14,"LAC","SEA",30,21,9,"2014"
"3741","2014_02_STL_TB",2014-09-14,"TB","LA",17,19,-2,"2014"
"3742","2014_03_BAL_CLE",2014-09-21,"CLE","BAL",21,23,-2,"2014"
"3743","2014_03_CHI_NYJ",2014-09-22,"NYJ","CHI",19,27,-8,"2014"
"3744","2014_03_DAL_STL",2014-09-21,"LA","DAL",31,34,-3,"2014"
"3745","2014_03_DEN_SEA",2014-09-21,"SEA","DEN",26,20,6,"2014"
"3746","2014_03_GB_DET",2014-09-21,"DET","GB",19,7,12,"2014"
"3747","2014_03_HOU_NYG",2014-09-21,"NYG","HOU",30,17,13,"2014"
"3748","2014_03_IND_JAX",2014-09-21,"JAX","IND",17,44,-27,"2014"
"3749","2014_03_KC_MIA",2014-09-21,"MIA","KC",15,34,-19,"2014"
"3750","2014_03_MIN_NO",2014-09-21,"NO","MIN",20,9,11,"2014"
"3751","2014_03_OAK_NE",2014-09-21,"NE","LV",16,9,7,"2014"
"3752","2014_03_PIT_CAR",2014-09-21,"CAR","PIT",19,37,-18,"2014"
"3753","2014_03_SD_BUF",2014-09-21,"BUF","LAC",10,22,-12,"2014"
"3754","2014_03_SF_ARI",2014-09-21,"ARI","SF",23,14,9,"2014"
"3755","2014_03_TB_ATL",2014-09-18,"ATL","TB",56,14,42,"2014"
"3756","2014_03_TEN_CIN",2014-09-21,"CIN","TEN",33,7,26,"2014"
"3757","2014_03_WAS_PHI",2014-09-21,"PHI","WAS",37,34,3,"2014"
"3758","2014_04_ATL_MIN",2014-09-28,"MIN","ATL",41,28,13,"2014"
"3759","2014_04_BUF_HOU",2014-09-28,"HOU","BUF",23,17,6,"2014"
"3760","2014_04_CAR_BAL",2014-09-28,"BAL","CAR",38,10,28,"2014"
"3761","2014_04_DET_NYJ",2014-09-28,"NYJ","DET",17,24,-7,"2014"
"3762","2014_04_GB_CHI",2014-09-28,"CHI","GB",17,38,-21,"2014"
"3763","2014_04_JAX_SD",2014-09-28,"LAC","JAX",33,14,19,"2014"
"3764","2014_04_MIA_OAK",2014-09-28,"LV","MIA",14,38,-24,"2014"
"3765","2014_04_NE_KC",2014-09-29,"KC","NE",41,14,27,"2014"
"3766","2014_04_NO_DAL",2014-09-28,"DAL","NO",38,17,21,"2014"
"3767","2014_04_NYG_WAS",2014-09-25,"WAS","NYG",14,45,-31,"2014"
"3768","2014_04_PHI_SF",2014-09-28,"SF","PHI",26,21,5,"2014"
"3769","2014_04_TB_PIT",2014-09-28,"PIT","TB",24,27,-3,"2014"
"3770","2014_04_TEN_IND",2014-09-28,"IND","TEN",41,17,24,"2014"
"3771","2014_05_ARI_DEN",2014-10-05,"DEN","ARI",41,20,21,"2014"
"3772","2014_05_ATL_NYG",2014-10-05,"NYG","ATL",30,20,10,"2014"
"3773","2014_05_BAL_IND",2014-10-05,"IND","BAL",20,13,7,"2014"
"3774","2014_05_BUF_DET",2014-10-05,"DET","BUF",14,17,-3,"2014"
"3775","2014_05_CHI_CAR",2014-10-05,"CAR","CHI",31,24,7,"2014"
"3776","2014_05_CIN_NE",2014-10-05,"NE","CIN",43,17,26,"2014"
"3777","2014_05_CLE_TEN",2014-10-05,"TEN","CLE",28,29,-1,"2014"
"3778","2014_05_HOU_DAL",2014-10-05,"DAL","HOU",20,17,3,"2014"
"3779","2014_05_KC_SF",2014-10-05,"SF","KC",22,17,5,"2014"
"3780","2014_05_MIN_GB",2014-10-02,"GB","MIN",42,10,32,"2014"
"3781","2014_05_NYJ_SD",2014-10-05,"LAC","NYJ",31,0,31,"2014"
"3782","2014_05_PIT_JAX",2014-10-05,"JAX","PIT",9,17,-8,"2014"
"3783","2014_05_SEA_WAS",2014-10-06,"WAS","SEA",17,27,-10,"2014"
"3784","2014_05_STL_PHI",2014-10-05,"PHI","LA",34,28,6,"2014"
"3785","2014_05_TB_NO",2014-10-05,"NO","TB",37,31,6,"2014"
"3786","2014_06_BAL_TB",2014-10-12,"TB","BAL",17,48,-31,"2014"
"3787","2014_06_CAR_CIN",2014-10-12,"CIN","CAR",37,37,0,"2014"
"3788","2014_06_CHI_ATL",2014-10-12,"ATL","CHI",13,27,-14,"2014"
"3789","2014_06_DAL_SEA",2014-10-12,"SEA","DAL",23,30,-7,"2014"
"3790","2014_06_DEN_NYJ",2014-10-12,"NYJ","DEN",17,31,-14,"2014"
"3791","2014_06_DET_MIN",2014-10-12,"MIN","DET",3,17,-14,"2014"
"3792","2014_06_GB_MIA",2014-10-12,"MIA","GB",24,27,-3,"2014"
"3793","2014_06_IND_HOU",2014-10-09,"HOU","IND",28,33,-5,"2014"
"3794","2014_06_JAX_TEN",2014-10-12,"TEN","JAX",16,14,2,"2014"
"3795","2014_06_NE_BUF",2014-10-12,"BUF","NE",22,37,-15,"2014"
"3796","2014_06_NYG_PHI",2014-10-12,"PHI","NYG",27,0,27,"2014"
"3797","2014_06_PIT_CLE",2014-10-12,"CLE","PIT",31,10,21,"2014"
"3798","2014_06_SD_OAK",2014-10-12,"LV","LAC",28,31,-3,"2014"
"3799","2014_06_SF_STL",2014-10-13,"LA","SF",17,31,-14,"2014"
"3800","2014_06_WAS_ARI",2014-10-12,"ARI","WAS",30,20,10,"2014"
"3801","2014_07_ARI_OAK",2014-10-19,"LV","ARI",13,24,-11,"2014"
"3802","2014_07_ATL_BAL",2014-10-19,"BAL","ATL",29,7,22,"2014"
"3803","2014_07_CAR_GB",2014-10-19,"GB","CAR",38,17,21,"2014"
"3804","2014_07_CIN_IND",2014-10-19,"IND","CIN",27,0,27,"2014"
"3805","2014_07_CLE_JAX",2014-10-19,"JAX","CLE",24,6,18,"2014"
"3806","2014_07_HOU_PIT",2014-10-20,"PIT","HOU",30,23,7,"2014"
"3807","2014_07_KC_SD",2014-10-19,"LAC","KC",20,23,-3,"2014"
"3808","2014_07_MIA_CHI",2014-10-19,"CHI","MIA",14,27,-13,"2014"
"3809","2014_07_MIN_BUF",2014-10-19,"BUF","MIN",17,16,1,"2014"
"3810","2014_07_NO_DET",2014-10-19,"DET","NO",24,23,1,"2014"
"3811","2014_07_NYG_DAL",2014-10-19,"DAL","NYG",31,21,10,"2014"
"3812","2014_07_NYJ_NE",2014-10-16,"NE","NYJ",27,25,2,"2014"
"3813","2014_07_SEA_STL",2014-10-19,"LA","SEA",28,26,2,"2014"
"3814","2014_07_SF_DEN",2014-10-19,"DEN","SF",42,17,25,"2014"
"3815","2014_07_TEN_WAS",2014-10-19,"WAS","TEN",19,17,2,"2014"
"3816","2014_08_BAL_CIN",2014-10-26,"CIN","BAL",27,24,3,"2014"
"3817","2014_08_BUF_NYJ",2014-10-26,"NYJ","BUF",23,43,-20,"2014"
"3818","2014_08_CHI_NE",2014-10-26,"NE","CHI",51,23,28,"2014"
"3819","2014_08_DET_ATL",2014-10-26,"ATL","DET",21,22,-1,"2014"
"3820","2014_08_GB_NO",2014-10-26,"NO","GB",44,23,21,"2014"
"3821","2014_08_HOU_TEN",2014-10-26,"TEN","HOU",16,30,-14,"2014"
"3822","2014_08_IND_PIT",2014-10-26,"PIT","IND",51,34,17,"2014"
"3823","2014_08_MIA_JAX",2014-10-26,"JAX","MIA",13,27,-14,"2014"
"3824","2014_08_MIN_TB",2014-10-26,"TB","MIN",13,19,-6,"2014"
"3825","2014_08_OAK_CLE",2014-10-26,"CLE","LV",23,13,10,"2014"
"3826","2014_08_PHI_ARI",2014-10-26,"ARI","PHI",24,20,4,"2014"
"3827","2014_08_SD_DEN",2014-10-23,"DEN","LAC",35,21,14,"2014"
"3828","2014_08_SEA_CAR",2014-10-26,"CAR","SEA",9,13,-4,"2014"
"3829","2014_08_STL_KC",2014-10-26,"KC","LA",34,7,27,"2014"
"3830","2014_08_WAS_DAL",2014-10-27,"DAL","WAS",17,20,-3,"2014"
"3831","2014_09_ARI_DAL",2014-11-02,"DAL","ARI",17,28,-11,"2014"
"3832","2014_09_BAL_PIT",2014-11-02,"PIT","BAL",43,23,20,"2014"
"3833","2014_09_DEN_NE",2014-11-02,"NE","DEN",43,21,22,"2014"
"3834","2014_09_IND_NYG",2014-11-03,"NYG","IND",24,40,-16,"2014"
"3835","2014_09_JAX_CIN",2014-11-02,"CIN","JAX",33,23,10,"2014"
"3836","2014_09_NO_CAR",2014-10-30,"CAR","NO",10,28,-18,"2014"
"3837","2014_09_NYJ_KC",2014-11-02,"KC","NYJ",24,10,14,"2014"
"3838","2014_09_OAK_SEA",2014-11-02,"SEA","LV",30,24,6,"2014"
"3839","2014_09_PHI_HOU",2014-11-02,"HOU","PHI",21,31,-10,"2014"
"3840","2014_09_SD_MIA",2014-11-02,"MIA","LAC",37,0,37,"2014"
"3841","2014_09_STL_SF",2014-11-02,"SF","LA",10,13,-3,"2014"
"3842","2014_09_TB_CLE",2014-11-02,"CLE","TB",22,17,5,"2014"
"3843","2014_09_WAS_MIN",2014-11-02,"MIN","WAS",29,26,3,"2014"
"3844","2014_10_ATL_TB",2014-11-09,"TB","ATL",17,27,-10,"2014"
"3845","2014_10_CAR_PHI",2014-11-10,"PHI","CAR",45,21,24,"2014"
"3846","2014_10_CHI_GB",2014-11-09,"GB","CHI",55,14,41,"2014"
"3847","2014_10_CLE_CIN",2014-11-06,"CIN","CLE",3,24,-21,"2014"
"3848","2014_10_DAL_JAX",2014-11-09,"JAX","DAL",17,31,-14,"2014"
"3849","2014_10_DEN_OAK",2014-11-09,"LV","DEN",17,41,-24,"2014"
"3850","2014_10_KC_BUF",2014-11-09,"BUF","KC",13,17,-4,"2014"
"3851","2014_10_MIA_DET",2014-11-09,"DET","MIA",20,16,4,"2014"
"3852","2014_10_NYG_SEA",2014-11-09,"SEA","NYG",38,17,21,"2014"
"3853","2014_10_PIT_NYJ",2014-11-09,"NYJ","PIT",20,13,7,"2014"
"3854","2014_10_SF_NO",2014-11-09,"NO","SF",24,27,-3,"2014"
"3855","2014_10_STL_ARI",2014-11-09,"ARI","LA",31,14,17,"2014"
"3856","2014_10_TEN_BAL",2014-11-09,"BAL","TEN",21,7,14,"2014"
"3857","2014_11_ATL_CAR",2014-11-16,"CAR","ATL",17,19,-2,"2014"
"3858","2014_11_BUF_MIA",2014-11-13,"MIA","BUF",22,9,13,"2014"
"3859","2014_11_CIN_NO",2014-11-16,"NO","CIN",10,27,-17,"2014"
"3860","2014_11_DEN_STL",2014-11-16,"LA","DEN",22,7,15,"2014"
"3861","2014_11_DET_ARI",2014-11-16,"ARI","DET",14,6,8,"2014"
"3862","2014_11_HOU_CLE",2014-11-16,"CLE","HOU",7,23,-16,"2014"
"3863","2014_11_MIN_CHI",2014-11-16,"CHI","MIN",21,13,8,"2014"
"3864","2014_11_NE_IND",2014-11-16,"IND","NE",20,42,-22,"2014"
"3865","2014_11_OAK_SD",2014-11-16,"LAC","LV",13,6,7,"2014"
"3866","2014_11_PHI_GB",2014-11-16,"GB","PHI",53,20,33,"2014"
"3867","2014_11_PIT_TEN",2014-11-17,"TEN","PIT",24,27,-3,"2014"
"3868","2014_11_SEA_KC",2014-11-16,"KC","SEA",24,20,4,"2014"
"3869","2014_11_SF_NYG",2014-11-16,"NYG","SF",10,16,-6,"2014"
"3870","2014_11_TB_WAS",2014-11-16,"WAS","TB",7,27,-20,"2014"
"3871","2014_12_ARI_SEA",2014-11-23,"SEA","ARI",19,3,16,"2014"
"3872","2014_12_BAL_NO",2014-11-24,"NO","BAL",27,34,-7,"2014"
"3873","2014_12_CIN_HOU",2014-11-23,"HOU","CIN",13,22,-9,"2014"
"3874","2014_12_CLE_ATL",2014-11-23,"ATL","CLE",24,26,-2,"2014"
"3875","2014_12_DAL_NYG",2014-11-23,"NYG","DAL",28,31,-3,"2014"
"3876","2014_12_DET_NE",2014-11-23,"NE","DET",34,9,25,"2014"
"3877","2014_12_GB_MIN",2014-11-23,"MIN","GB",21,24,-3,"2014"
"3878","2014_12_JAX_IND",2014-11-23,"IND","JAX",23,3,20,"2014"
"3879","2014_12_KC_OAK",2014-11-20,"LV","KC",24,20,4,"2014"
"3880","2014_12_MIA_DEN",2014-11-23,"DEN","MIA",39,36,3,"2014"
"3881","2014_12_NYJ_BUF",2014-11-24,"BUF","NYJ",38,3,35,"2014"
"3882","2014_12_STL_SD",2014-11-23,"LAC","LA",27,24,3,"2014"
"3883","2014_12_TB_CHI",2014-11-23,"CHI","TB",21,13,8,"2014"
"3884","2014_12_TEN_PHI",2014-11-23,"PHI","TEN",43,24,19,"2014"
"3885","2014_12_WAS_SF",2014-11-23,"SF","WAS",17,13,4,"2014"
"3886","2014_13_ARI_ATL",2014-11-30,"ATL","ARI",29,18,11,"2014"
"3887","2014_13_CAR_MIN",2014-11-30,"MIN","CAR",31,13,18,"2014"
"3888","2014_13_CHI_DET",2014-11-27,"DET","CHI",34,17,17,"2014"
"3889","2014_13_CIN_TB",2014-11-30,"TB","CIN",13,14,-1,"2014"
"3890","2014_13_CLE_BUF",2014-11-30,"BUF","CLE",26,10,16,"2014"
"3891","2014_13_DEN_KC",2014-11-30,"KC","DEN",16,29,-13,"2014"
"3892","2014_13_MIA_NYJ",2014-12-01,"NYJ","MIA",13,16,-3,"2014"
"3893","2014_13_NE_GB",2014-11-30,"GB","NE",26,21,5,"2014"
"3894","2014_13_NO_PIT",2014-11-30,"PIT","NO",32,35,-3,"2014"
"3895","2014_13_NYG_JAX",2014-11-30,"JAX","NYG",25,24,1,"2014"
"3896","2014_13_OAK_STL",2014-11-30,"LA","LV",52,0,52,"2014"
"3897","2014_13_PHI_DAL",2014-11-27,"DAL","PHI",10,33,-23,"2014"
"3898","2014_13_SD_BAL",2014-11-30,"BAL","LAC",33,34,-1,"2014"
"3899","2014_13_SEA_SF",2014-11-27,"SF","SEA",3,19,-16,"2014"
"3900","2014_13_TEN_HOU",2014-11-30,"HOU","TEN",45,21,24,"2014"
"3901","2014_13_WAS_IND",2014-11-30,"IND","WAS",49,27,22,"2014"
"3902","2014_14_ATL_GB",2014-12-08,"GB","ATL",43,37,6,"2014"
"3903","2014_14_BAL_MIA",2014-12-07,"MIA","BAL",13,28,-15,"2014"
"3904","2014_14_BUF_DEN",2014-12-07,"DEN","BUF",24,17,7,"2014"
"3905","2014_14_CAR_NO",2014-12-07,"NO","CAR",10,41,-31,"2014"
"3906","2014_14_DAL_CHI",2014-12-04,"CHI","DAL",28,41,-13,"2014"
"3907","2014_14_HOU_JAX",2014-12-07,"JAX","HOU",13,27,-14,"2014"
"3908","2014_14_IND_CLE",2014-12-07,"CLE","IND",24,25,-1,"2014"
"3909","2014_14_KC_ARI",2014-12-07,"ARI","KC",17,14,3,"2014"
"3910","2014_14_NE_SD",2014-12-07,"LAC","NE",14,23,-9,"2014"
"3911","2014_14_NYG_TEN",2014-12-07,"TEN","NYG",7,36,-29,"2014"
"3912","2014_14_NYJ_MIN",2014-12-07,"MIN","NYJ",30,24,6,"2014"
"3913","2014_14_PIT_CIN",2014-12-07,"CIN","PIT",21,42,-21,"2014"
"3914","2014_14_SEA_PHI",2014-12-07,"PHI","SEA",14,24,-10,"2014"
"3915","2014_14_SF_OAK",2014-12-07,"LV","SF",24,13,11,"2014"
"3916","2014_14_STL_WAS",2014-12-07,"WAS","LA",0,24,-24,"2014"
"3917","2014_14_TB_DET",2014-12-07,"DET","TB",34,17,17,"2014"
"3918","2014_15_ARI_STL",2014-12-11,"LA","ARI",6,12,-6,"2014"
"3919","2014_15_CIN_CLE",2014-12-14,"CLE","CIN",0,30,-30,"2014"
"3920","2014_15_DAL_PHI",2014-12-14,"PHI","DAL",27,38,-11,"2014"
"3921","2014_15_DEN_SD",2014-12-14,"LAC","DEN",10,22,-12,"2014"
"3922","2014_15_GB_BUF",2014-12-14,"BUF","GB",21,13,8,"2014"
"3923","2014_15_HOU_IND",2014-12-14,"IND","HOU",17,10,7,"2014"
"3924","2014_15_JAX_BAL",2014-12-14,"BAL","JAX",20,12,8,"2014"
"3925","2014_15_MIA_NE",2014-12-14,"NE","MIA",41,13,28,"2014"
"3926","2014_15_MIN_DET",2014-12-14,"DET","MIN",16,14,2,"2014"
"3927","2014_15_NO_CHI",2014-12-15,"CHI","NO",15,31,-16,"2014"
"3928","2014_15_NYJ_TEN",2014-12-14,"TEN","NYJ",11,16,-5,"2014"
"3929","2014_15_OAK_KC",2014-12-14,"KC","LV",31,13,18,"2014"
"3930","2014_15_PIT_ATL",2014-12-14,"ATL","PIT",20,27,-7,"2014"
"3931","2014_15_SF_SEA",2014-12-14,"SEA","SF",17,7,10,"2014"
"3932","2014_15_TB_CAR",2014-12-14,"CAR","TB",19,17,2,"2014"
"3933","2014_15_WAS_NYG",2014-12-14,"NYG","WAS",24,13,11,"2014"
"3934","2014_16_ATL_NO",2014-12-21,"NO","ATL",14,30,-16,"2014"
"3935","2014_16_BAL_HOU",2014-12-21,"HOU","BAL",25,13,12,"2014"
"3936","2014_16_BUF_OAK",2014-12-21,"LV","BUF",26,24,2,"2014"
"3937","2014_16_CLE_CAR",2014-12-21,"CAR","CLE",17,13,4,"2014"
"3938","2014_16_DEN_CIN",2014-12-22,"CIN","DEN",37,28,9,"2014"
"3939","2014_16_DET_CHI",2014-12-21,"CHI","DET",14,20,-6,"2014"
"3940","2014_16_GB_TB",2014-12-21,"TB","GB",3,20,-17,"2014"
"3941","2014_16_IND_DAL",2014-12-21,"DAL","IND",42,7,35,"2014"
"3942","2014_16_KC_PIT",2014-12-21,"PIT","KC",20,12,8,"2014"
"3943","2014_16_MIN_MIA",2014-12-21,"MIA","MIN",37,35,2,"2014"
"3944","2014_16_NE_NYJ",2014-12-21,"NYJ","NE",16,17,-1,"2014"
"3945","2014_16_NYG_STL",2014-12-21,"LA","NYG",27,37,-10,"2014"
"3946","2014_16_PHI_WAS",2014-12-20,"WAS","PHI",27,24,3,"2014"
"3947","2014_16_SD_SF",2014-12-20,"SF","LAC",35,38,-3,"2014"
"3948","2014_16_SEA_ARI",2014-12-21,"ARI","SEA",6,35,-29,"2014"
"3949","2014_16_TEN_JAX",2014-12-18,"JAX","TEN",21,13,8,"2014"
"3950","2014_17_ARI_SF",2014-12-28,"SF","ARI",20,17,3,"2014"
"3951","2014_17_BUF_NE",2014-12-28,"NE","BUF",9,17,-8,"2014"
"3952","2014_17_CAR_ATL",2014-12-28,"ATL","CAR",3,34,-31,"2014"
"3953","2014_17_CHI_MIN",2014-12-28,"MIN","CHI",13,9,4,"2014"
"3954","2014_17_CIN_PIT",2014-12-28,"PIT","CIN",27,17,10,"2014"
"3955","2014_17_CLE_BAL",2014-12-28,"BAL","CLE",20,10,10,"2014"
"3956","2014_17_DAL_WAS",2014-12-28,"WAS","DAL",17,44,-27,"2014"
"3957","2014_17_DET_GB",2014-12-28,"GB","DET",30,20,10,"2014"
"3958","2014_17_IND_TEN",2014-12-28,"TEN","IND",10,27,-17,"2014"
"3959","2014_17_JAX_HOU",2014-12-28,"HOU","JAX",23,17,6,"2014"
"3960","2014_17_NO_TB",2014-12-28,"TB","NO",20,23,-3,"2014"
"3961","2014_17_NYJ_MIA",2014-12-28,"MIA","NYJ",24,37,-13,"2014"
"3962","2014_17_OAK_DEN",2014-12-28,"DEN","LV",47,14,33,"2014"
"3963","2014_17_PHI_NYG",2014-12-28,"NYG","PHI",26,34,-8,"2014"
"3964","2014_17_SD_KC",2014-12-28,"KC","LAC",19,7,12,"2014"
"3965","2014_17_STL_SEA",2014-12-28,"SEA","LA",20,6,14,"2014"
"3966","2015_01_BAL_DEN",2015-09-13,"DEN","BAL",19,13,6,"2015"
"3967","2015_01_CAR_JAX",2015-09-13,"JAX","CAR",9,20,-11,"2015"
"3968","2015_01_CIN_OAK",2015-09-13,"LV","CIN",13,33,-20,"2015"
"3969","2015_01_CLE_NYJ",2015-09-13,"NYJ","CLE",31,10,21,"2015"
"3970","2015_01_DET_SD",2015-09-13,"LAC","DET",33,28,5,"2015"
"3971","2015_01_GB_CHI",2015-09-13,"CHI","GB",23,31,-8,"2015"
"3972","2015_01_IND_BUF",2015-09-13,"BUF","IND",27,14,13,"2015"
"3973","2015_01_KC_HOU",2015-09-13,"HOU","KC",20,27,-7,"2015"
"3974","2015_01_MIA_WAS",2015-09-13,"WAS","MIA",10,17,-7,"2015"
"3975","2015_01_MIN_SF",2015-09-14,"SF","MIN",20,3,17,"2015"
"3976","2015_01_NO_ARI",2015-09-13,"ARI","NO",31,19,12,"2015"
"3977","2015_01_NYG_DAL",2015-09-13,"DAL","NYG",27,26,1,"2015"
"3978","2015_01_PHI_ATL",2015-09-14,"ATL","PHI",26,24,2,"2015"
"3979","2015_01_PIT_NE",2015-09-10,"NE","PIT",28,21,7,"2015"
"3980","2015_01_SEA_STL",2015-09-13,"LA","SEA",34,31,3,"2015"
"3981","2015_01_TEN_TB",2015-09-13,"TB","TEN",14,42,-28,"2015"
"3982","2015_02_ARI_CHI",2015-09-20,"CHI","ARI",23,48,-25,"2015"
"3983","2015_02_ATL_NYG",2015-09-20,"NYG","ATL",20,24,-4,"2015"
"3984","2015_02_BAL_OAK",2015-09-20,"LV","BAL",37,33,4,"2015"
"3985","2015_02_DAL_PHI",2015-09-20,"PHI","DAL",10,20,-10,"2015"
"3986","2015_02_DEN_KC",2015-09-17,"KC","DEN",24,31,-7,"2015"
"3987","2015_02_DET_MIN",2015-09-20,"MIN","DET",26,16,10,"2015"
"3988","2015_02_HOU_CAR",2015-09-20,"CAR","HOU",24,17,7,"2015"
"3989","2015_02_MIA_JAX",2015-09-20,"JAX","MIA",23,20,3,"2015"
"3990","2015_02_NE_BUF",2015-09-20,"BUF","NE",32,40,-8,"2015"
"3991","2015_02_NYJ_IND",2015-09-21,"IND","NYJ",7,20,-13,"2015"
"3992","2015_02_SD_CIN",2015-09-20,"CIN","LAC",24,19,5,"2015"
"3993","2015_02_SEA_GB",2015-09-20,"GB","SEA",27,17,10,"2015"
"3994","2015_02_SF_PIT",2015-09-20,"PIT","SF",43,18,25,"2015"
"3995","2015_02_STL_WAS",2015-09-20,"WAS","LA",24,10,14,"2015"
"3996","2015_02_TB_NO",2015-09-20,"NO","TB",19,26,-7,"2015"
"3997","2015_02_TEN_CLE",2015-09-20,"CLE","TEN",28,14,14,"2015"
"3998","2015_03_ATL_DAL",2015-09-27,"DAL","ATL",28,39,-11,"2015"
"3999","2015_03_BUF_MIA",2015-09-27,"MIA","BUF",14,41,-27,"2015"
"4000","2015_03_CHI_SEA",2015-09-27,"SEA","CHI",26,0,26,"2015"
"4001","2015_03_CIN_BAL",2015-09-27,"BAL","CIN",24,28,-4,"2015"
"4002","2015_03_DEN_DET",2015-09-27,"DET","DEN",12,24,-12,"2015"
"4003","2015_03_IND_TEN",2015-09-27,"TEN","IND",33,35,-2,"2015"
"4004","2015_03_JAX_NE",2015-09-27,"NE","JAX",51,17,34,"2015"
"4005","2015_03_KC_GB",2015-09-28,"GB","KC",38,28,10,"2015"
"4006","2015_03_NO_CAR",2015-09-27,"CAR","NO",27,22,5,"2015"
"4007","2015_03_OAK_CLE",2015-09-27,"CLE","LV",20,27,-7,"2015"
"4008","2015_03_PHI_NYJ",2015-09-27,"NYJ","PHI",17,24,-7,"2015"
"4009","2015_03_PIT_STL",2015-09-27,"LA","PIT",6,12,-6,"2015"
"4010","2015_03_SD_MIN",2015-09-27,"MIN","LAC",31,14,17,"2015"
"4011","2015_03_SF_ARI",2015-09-27,"ARI","SF",47,7,40,"2015"
"4012","2015_03_TB_HOU",2015-09-27,"HOU","TB",19,9,10,"2015"
"4013","2015_03_WAS_NYG",2015-09-24,"NYG","WAS",32,21,11,"2015"
"4014","2015_04_BAL_PIT",2015-10-01,"PIT","BAL",20,23,-3,"2015"
"4015","2015_04_CAR_TB",2015-10-04,"TB","CAR",23,37,-14,"2015"
"4016","2015_04_CLE_SD",2015-10-04,"LAC","CLE",30,27,3,"2015"
"4017","2015_04_DAL_NO",2015-10-04,"NO","DAL",26,20,6,"2015"
"4018","2015_04_DET_SEA",2015-10-05,"SEA","DET",13,10,3,"2015"
"4019","2015_04_GB_SF",2015-10-04,"SF","GB",3,17,-14,"2015"
"4020","2015_04_HOU_ATL",2015-10-04,"ATL","HOU",48,21,27,"2015"
"4021","2015_04_JAX_IND",2015-10-04,"IND","JAX",16,13,3,"2015"
"4022","2015_04_KC_CIN",2015-10-04,"CIN","KC",36,21,15,"2015"
"4023","2015_04_MIN_DEN",2015-10-04,"DEN","MIN",23,20,3,"2015"
"4024","2015_04_NYG_BUF",2015-10-04,"BUF","NYG",10,24,-14,"2015"
"4025","2015_04_NYJ_MIA",2015-10-04,"MIA","NYJ",14,27,-13,"2015"
"4026","2015_04_OAK_CHI",2015-10-04,"CHI","LV",22,20,2,"2015"
"4027","2015_04_PHI_WAS",2015-10-04,"WAS","PHI",23,20,3,"2015"
"4028","2015_04_STL_ARI",2015-10-04,"ARI","LA",22,24,-2,"2015"
"4029","2015_05_ARI_DET",2015-10-11,"DET","ARI",17,42,-25,"2015"
"4030","2015_05_BUF_TEN",2015-10-11,"TEN","BUF",13,14,-1,"2015"
"4031","2015_05_CHI_KC",2015-10-11,"KC","CHI",17,18,-1,"2015"
"4032","2015_05_CLE_BAL",2015-10-11,"BAL","CLE",30,33,-3,"2015"
"4033","2015_05_DEN_OAK",2015-10-11,"LV","DEN",10,16,-6,"2015"
"4034","2015_05_IND_HOU",2015-10-08,"HOU","IND",20,27,-7,"2015"
"4035","2015_05_JAX_TB",2015-10-11,"TB","JAX",38,31,7,"2015"
"4036","2015_05_NE_DAL",2015-10-11,"DAL","NE",6,30,-24,"2015"
"4037","2015_05_NO_PHI",2015-10-11,"PHI","NO",39,17,22,"2015"
"4038","2015_05_PIT_SD",2015-10-12,"LAC","PIT",20,24,-4,"2015"
"4039","2015_05_SEA_CIN",2015-10-11,"CIN","SEA",27,24,3,"2015"
"4040","2015_05_SF_NYG",2015-10-11,"NYG","SF",30,27,3,"2015"
"4041","2015_05_STL_GB",2015-10-11,"GB","LA",24,10,14,"2015"
"4042","2015_05_WAS_ATL",2015-10-11,"ATL","WAS",25,19,6,"2015"
"4043","2015_06_ARI_PIT",2015-10-18,"PIT","ARI",25,13,12,"2015"
"4044","2015_06_ATL_NO",2015-10-15,"NO","ATL",31,21,10,"2015"
"4045","2015_06_BAL_SF",2015-10-18,"SF","BAL",25,20,5,"2015"
"4046","2015_06_CAR_SEA",2015-10-18,"SEA","CAR",23,27,-4,"2015"
"4047","2015_06_CHI_DET",2015-10-18,"DET","CHI",37,34,3,"2015"
"4048","2015_06_CIN_BUF",2015-10-18,"BUF","CIN",21,34,-13,"2015"
"4049","2015_06_DEN_CLE",2015-10-18,"CLE","DEN",23,26,-3,"2015"
"4050","2015_06_HOU_JAX",2015-10-18,"JAX","HOU",20,31,-11,"2015"
"4051","2015_06_KC_MIN",2015-10-18,"MIN","KC",16,10,6,"2015"
"4052","2015_06_MIA_TEN",2015-10-18,"TEN","MIA",10,38,-28,"2015"
"4053","2015_06_NE_IND",2015-10-18,"IND","NE",27,34,-7,"2015"
"4054","2015_06_NYG_PHI",2015-10-19,"PHI","NYG",27,7,20,"2015"
"4055","2015_06_SD_GB",2015-10-18,"GB","LAC",27,20,7,"2015"
"4056","2015_06_WAS_NYJ",2015-10-18,"NYJ","WAS",34,20,14,"2015"
"4057","2015_07_ATL_TEN",2015-10-25,"TEN","ATL",7,10,-3,"2015"
"4058","2015_07_BAL_ARI",2015-10-26,"ARI","BAL",26,18,8,"2015"
"4059","2015_07_BUF_JAX",2015-10-25,"JAX","BUF",34,31,3,"2015"
"4060","2015_07_CLE_STL",2015-10-25,"LA","CLE",24,6,18,"2015"
"4061","2015_07_DAL_NYG",2015-10-25,"NYG","DAL",27,20,7,"2015"
"4062","2015_07_HOU_MIA",2015-10-25,"MIA","HOU",44,26,18,"2015"
"4063","2015_07_MIN_DET",2015-10-25,"DET","MIN",19,28,-9,"2015"
"4064","2015_07_NO_IND",2015-10-25,"IND","NO",21,27,-6,"2015"
"4065","2015_07_NYJ_NE",2015-10-25,"NE","NYJ",30,23,7,"2015"
"4066","2015_07_OAK_SD",2015-10-25,"LAC","LV",29,37,-8,"2015"
"4067","2015_07_PHI_CAR",2015-10-25,"CAR","PHI",27,16,11,"2015"
"4068","2015_07_PIT_KC",2015-10-25,"KC","PIT",23,13,10,"2015"
"4069","2015_07_SEA_SF",2015-10-22,"SF","SEA",3,20,-17,"2015"
"4070","2015_07_TB_WAS",2015-10-25,"WAS","TB",31,30,1,"2015"
"4071","2015_08_ARI_CLE",2015-11-01,"CLE","ARI",20,34,-14,"2015"
"4072","2015_08_CIN_PIT",2015-11-01,"PIT","CIN",10,16,-6,"2015"
"4073","2015_08_DET_KC",2015-11-01,"KC","DET",45,10,35,"2015"
"4074","2015_08_GB_DEN",2015-11-01,"DEN","GB",29,10,19,"2015"
"4075","2015_08_IND_CAR",2015-11-02,"CAR","IND",29,26,3,"2015"
"4076","2015_08_MIA_NE",2015-10-29,"NE","MIA",36,7,29,"2015"
"4077","2015_08_MIN_CHI",2015-11-01,"CHI","MIN",20,23,-3,"2015"
"4078","2015_08_NYG_NO",2015-11-01,"NO","NYG",52,49,3,"2015"
"4079","2015_08_NYJ_OAK",2015-11-01,"LV","NYJ",34,20,14,"2015"
"4080","2015_08_SD_BAL",2015-11-01,"BAL","LAC",29,26,3,"2015"
"4081","2015_08_SEA_DAL",2015-11-01,"DAL","SEA",12,13,-1,"2015"
"4082","2015_08_SF_STL",2015-11-01,"LA","SF",27,6,21,"2015"
"4083","2015_08_TB_ATL",2015-11-01,"ATL","TB",20,23,-3,"2015"
"4084","2015_08_TEN_HOU",2015-11-01,"HOU","TEN",20,6,14,"2015"
"4085","2015_09_ATL_SF",2015-11-08,"SF","ATL",17,16,1,"2015"
"4086","2015_09_CHI_SD",2015-11-09,"LAC","CHI",19,22,-3,"2015"
"4087","2015_09_CLE_CIN",2015-11-05,"CIN","CLE",31,10,21,"2015"
"4088","2015_09_DEN_IND",2015-11-08,"IND","DEN",27,24,3,"2015"
"4089","2015_09_GB_CAR",2015-11-08,"CAR","GB",37,29,8,"2015"
"4090","2015_09_JAX_NYJ",2015-11-08,"NYJ","JAX",28,23,5,"2015"
"4091","2015_09_MIA_BUF",2015-11-08,"BUF","MIA",33,17,16,"2015"
"4092","2015_09_NYG_TB",2015-11-08,"TB","NYG",18,32,-14,"2015"
"4093","2015_09_OAK_PIT",2015-11-08,"PIT","LV",38,35,3,"2015"
"4094","2015_09_PHI_DAL",2015-11-08,"DAL","PHI",27,33,-6,"2015"
"4095","2015_09_STL_MIN",2015-11-08,"MIN","LA",21,18,3,"2015"
"4096","2015_09_TEN_NO",2015-11-08,"NO","TEN",28,34,-6,"2015"
"4097","2015_09_WAS_NE",2015-11-08,"NE","WAS",27,10,17,"2015"
"4098","2015_10_ARI_SEA",2015-11-15,"SEA","ARI",32,39,-7,"2015"
"4099","2015_10_BUF_NYJ",2015-11-12,"NYJ","BUF",17,22,-5,"2015"
"4100","2015_10_CAR_TEN",2015-11-15,"TEN","CAR",10,27,-17,"2015"
"4101","2015_10_CHI_STL",2015-11-15,"LA","CHI",13,37,-24,"2015"
"4102","2015_10_CLE_PIT",2015-11-15,"PIT","CLE",30,9,21,"2015"
"4103","2015_10_DAL_TB",2015-11-15,"TB","DAL",10,6,4,"2015"
"4104","2015_10_DET_GB",2015-11-15,"GB","DET",16,18,-2,"2015"
"4105","2015_10_HOU_CIN",2015-11-16,"CIN","HOU",6,10,-4,"2015"
"4106","2015_10_JAX_BAL",2015-11-15,"BAL","JAX",20,22,-2,"2015"
"4107","2015_10_KC_DEN",2015-11-15,"DEN","KC",13,29,-16,"2015"
"4108","2015_10_MIA_PHI",2015-11-15,"PHI","MIA",19,20,-1,"2015"
"4109","2015_10_MIN_OAK",2015-11-15,"LV","MIN",14,30,-16,"2015"
"4110","2015_10_NE_NYG",2015-11-15,"NYG","NE",26,27,-1,"2015"
"4111","2015_10_NO_WAS",2015-11-15,"WAS","NO",47,14,33,"2015"
"4112","2015_11_BUF_NE",2015-11-23,"NE","BUF",20,13,7,"2015"
"4113","2015_11_CIN_ARI",2015-11-22,"ARI","CIN",34,31,3,"2015"
"4114","2015_11_DAL_MIA",2015-11-22,"MIA","DAL",14,24,-10,"2015"
"4115","2015_11_DEN_CHI",2015-11-22,"CHI","DEN",15,17,-2,"2015"
"4116","2015_11_GB_MIN",2015-11-22,"MIN","GB",13,30,-17,"2015"
"4117","2015_11_IND_ATL",2015-11-22,"ATL","IND",21,24,-3,"2015"
"4118","2015_11_KC_SD",2015-11-22,"LAC","KC",3,33,-30,"2015"
"4119","2015_11_NYJ_HOU",2015-11-22,"HOU","NYJ",24,17,7,"2015"
"4120","2015_11_OAK_DET",2015-11-22,"DET","LV",18,13,5,"2015"
"4121","2015_11_SF_SEA",2015-11-22,"SEA","SF",29,13,16,"2015"
"4122","2015_11_STL_BAL",2015-11-22,"BAL","LA",16,13,3,"2015"
"4123","2015_11_TB_PHI",2015-11-22,"PHI","TB",17,45,-28,"2015"
"4124","2015_11_TEN_JAX",2015-11-19,"JAX","TEN",19,13,6,"2015"
"4125","2015_11_WAS_CAR",2015-11-22,"CAR","WAS",44,16,28,"2015"
"4126","2015_12_ARI_SF",2015-11-29,"SF","ARI",13,19,-6,"2015"
"4127","2015_12_BAL_CLE",2015-11-30,"CLE","BAL",27,33,-6,"2015"
"4128","2015_12_BUF_KC",2015-11-29,"KC","BUF",30,22,8,"2015"
"4129","2015_12_CAR_DAL",2015-11-26,"DAL","CAR",14,33,-19,"2015"
"4130","2015_12_CHI_GB",2015-11-26,"GB","CHI",13,17,-4,"2015"
"4131","2015_12_MIA_NYJ",2015-11-29,"NYJ","MIA",38,20,18,"2015"
"4132","2015_12_MIN_ATL",2015-11-29,"ATL","MIN",10,20,-10,"2015"
"4133","2015_12_NE_DEN",2015-11-29,"DEN","NE",30,24,6,"2015"
"4134","2015_12_NO_HOU",2015-11-29,"HOU","NO",24,6,18,"2015"
"4135","2015_12_NYG_WAS",2015-11-29,"WAS","NYG",20,14,6,"2015"
"4136","2015_12_OAK_TEN",2015-11-29,"TEN","LV",21,24,-3,"2015"
"4137","2015_12_PHI_DET",2015-11-26,"DET","PHI",45,14,31,"2015"
"4138","2015_12_PIT_SEA",2015-11-29,"SEA","PIT",39,30,9,"2015"
"4139","2015_12_SD_JAX",2015-11-29,"JAX","LAC",25,31,-6,"2015"
"4140","2015_12_STL_CIN",2015-11-29,"CIN","LA",31,7,24,"2015"
"4141","2015_12_TB_IND",2015-11-29,"IND","TB",25,12,13,"2015"
"4142","2015_13_ARI_STL",2015-12-06,"LA","ARI",3,27,-24,"2015"
"4143","2015_13_ATL_TB",2015-12-06,"TB","ATL",23,19,4,"2015"
"4144","2015_13_BAL_MIA",2015-12-06,"MIA","BAL",15,13,2,"2015"
"4145","2015_13_CAR_NO",2015-12-06,"NO","CAR",38,41,-3,"2015"
"4146","2015_13_CIN_CLE",2015-12-06,"CLE","CIN",3,37,-34,"2015"
"4147","2015_13_DAL_WAS",2015-12-07,"WAS","DAL",16,19,-3,"2015"
"4148","2015_13_DEN_SD",2015-12-06,"LAC","DEN",3,17,-14,"2015"
"4149","2015_13_GB_DET",2015-12-03,"DET","GB",23,27,-4,"2015"
"4150","2015_13_HOU_BUF",2015-12-06,"BUF","HOU",30,21,9,"2015"
"4151","2015_13_IND_PIT",2015-12-06,"PIT","IND",45,10,35,"2015"
"4152","2015_13_JAX_TEN",2015-12-06,"TEN","JAX",42,39,3,"2015"
"4153","2015_13_KC_OAK",2015-12-06,"LV","KC",20,34,-14,"2015"
"4154","2015_13_NYJ_NYG",2015-12-06,"NYG","NYJ",20,23,-3,"2015"
"4155","2015_13_PHI_NE",2015-12-06,"NE","PHI",28,35,-7,"2015"
"4156","2015_13_SEA_MIN",2015-12-06,"MIN","SEA",7,38,-31,"2015"
"4157","2015_13_SF_CHI",2015-12-06,"CHI","SF",20,26,-6,"2015"
"4158","2015_14_ATL_CAR",2015-12-13,"CAR","ATL",38,0,38,"2015"
"4159","2015_14_BUF_PHI",2015-12-13,"PHI","BUF",23,20,3,"2015"
"4160","2015_14_DAL_GB",2015-12-13,"GB","DAL",28,7,21,"2015"
"4161","2015_14_DET_STL",2015-12-13,"LA","DET",21,14,7,"2015"
"4162","2015_14_IND_JAX",2015-12-13,"JAX","IND",51,16,35,"2015"
"4163","2015_14_MIN_ARI",2015-12-10,"ARI","MIN",23,20,3,"2015"
"4164","2015_14_NE_HOU",2015-12-13,"HOU","NE",6,27,-21,"2015"
"4165","2015_14_NO_TB",2015-12-13,"TB","NO",17,24,-7,"2015"
"4166","2015_14_NYG_MIA",2015-12-14,"MIA","NYG",24,31,-7,"2015"
"4167","2015_14_OAK_DEN",2015-12-13,"DEN","LV",12,15,-3,"2015"
"4168","2015_14_PIT_CIN",2015-12-13,"CIN","PIT",20,33,-13,"2015"
"4169","2015_14_SD_KC",2015-12-13,"KC","LAC",10,3,7,"2015"
"4170","2015_14_SEA_BAL",2015-12-13,"BAL","SEA",6,35,-29,"2015"
"4171","2015_14_SF_CLE",2015-12-13,"CLE","SF",24,10,14,"2015"
"4172","2015_14_TEN_NYJ",2015-12-13,"NYJ","TEN",30,8,22,"2015"
"4173","2015_14_WAS_CHI",2015-12-13,"CHI","WAS",21,24,-3,"2015"
"4174","2015_15_ARI_PHI",2015-12-20,"PHI","ARI",17,40,-23,"2015"
"4175","2015_15_ATL_JAX",2015-12-20,"JAX","ATL",17,23,-6,"2015"
"4176","2015_15_BUF_WAS",2015-12-20,"WAS","BUF",35,25,10,"2015"
"4177","2015_15_CAR_NYG",2015-12-20,"NYG","CAR",35,38,-3,"2015"
"4178","2015_15_CHI_MIN",2015-12-20,"MIN","CHI",38,17,21,"2015"
"4179","2015_15_CIN_SF",2015-12-20,"SF","CIN",14,24,-10,"2015"
"4180","2015_15_CLE_SEA",2015-12-20,"SEA","CLE",30,13,17,"2015"
"4181","2015_15_DEN_PIT",2015-12-20,"PIT","DEN",34,27,7,"2015"
"4182","2015_15_DET_NO",2015-12-21,"NO","DET",27,35,-8,"2015"
"4183","2015_15_GB_OAK",2015-12-20,"LV","GB",20,30,-10,"2015"
"4184","2015_15_HOU_IND",2015-12-20,"IND","HOU",10,16,-6,"2015"
"4185","2015_15_KC_BAL",2015-12-20,"BAL","KC",14,34,-20,"2015"
"4186","2015_15_MIA_SD",2015-12-20,"LAC","MIA",30,14,16,"2015"
"4187","2015_15_NYJ_DAL",2015-12-19,"DAL","NYJ",16,19,-3,"2015"
"4188","2015_15_TB_STL",2015-12-17,"LA","TB",31,23,8,"2015"
"4189","2015_15_TEN_NE",2015-12-20,"NE","TEN",33,16,17,"2015"
"4190","2015_16_CAR_ATL",2015-12-27,"ATL","CAR",20,13,7,"2015"
"4191","2015_16_CHI_TB",2015-12-27,"TB","CHI",21,26,-5,"2015"
"4192","2015_16_CIN_DEN",2015-12-28,"DEN","CIN",20,17,3,"2015"
"4193","2015_16_CLE_KC",2015-12-27,"KC","CLE",17,13,4,"2015"
"4194","2015_16_DAL_BUF",2015-12-27,"BUF","DAL",16,6,10,"2015"
"4195","2015_16_GB_ARI",2015-12-27,"ARI","GB",38,8,30,"2015"
"4196","2015_16_HOU_TEN",2015-12-27,"TEN","HOU",6,34,-28,"2015"
"4197","2015_16_IND_MIA",2015-12-27,"MIA","IND",12,18,-6,"2015"
"4198","2015_16_JAX_NO",2015-12-27,"NO","JAX",38,27,11,"2015"
"4199","2015_16_NE_NYJ",2015-12-27,"NYJ","NE",26,20,6,"2015"
"4200","2015_16_NYG_MIN",2015-12-27,"MIN","NYG",49,17,32,"2015"
"4201","2015_16_PIT_BAL",2015-12-27,"BAL","PIT",20,17,3,"2015"
"4202","2015_16_SD_OAK",2015-12-24,"LV","LAC",23,20,3,"2015"
"4203","2015_16_SF_DET",2015-12-27,"DET","SF",32,17,15,"2015"
"4204","2015_16_STL_SEA",2015-12-27,"SEA","LA",17,23,-6,"2015"
"4205","2015_16_WAS_PHI",2015-12-26,"PHI","WAS",24,38,-14,"2015"
"4206","2016_01_BUF_BAL",2016-09-11,"BAL","BUF",13,7,6,"2016"
"4207","2016_01_CAR_DEN",2016-09-08,"DEN","CAR",21,20,1,"2016"
"4208","2016_01_CHI_HOU",2016-09-11,"HOU","CHI",23,14,9,"2016"
"4209","2016_01_CIN_NYJ",2016-09-11,"NYJ","CIN",22,23,-1,"2016"
"4210","2016_01_CLE_PHI",2016-09-11,"PHI","CLE",29,10,19,"2016"
"4211","2016_01_DET_IND",2016-09-11,"IND","DET",35,39,-4,"2016"
"4212","2016_01_GB_JAX",2016-09-11,"JAX","GB",23,27,-4,"2016"
"4213","2016_01_LA_SF",2016-09-12,"SF","LA",28,0,28,"2016"
"4214","2016_01_MIA_SEA",2016-09-11,"SEA","MIA",12,10,2,"2016"
"4215","2016_01_MIN_TEN",2016-09-11,"TEN","MIN",16,25,-9,"2016"
"4216","2016_01_NE_ARI",2016-09-11,"ARI","NE",21,23,-2,"2016"
"4217","2016_01_NYG_DAL",2016-09-11,"DAL","NYG",19,20,-1,"2016"
"4218","2016_01_OAK_NO",2016-09-11,"NO","LV",34,35,-1,"2016"
"4219","2016_01_PIT_WAS",2016-09-12,"WAS","PIT",16,38,-22,"2016"
"4220","2016_01_SD_KC",2016-09-11,"KC","LAC",33,27,6,"2016"
"4221","2016_01_TB_ATL",2016-09-11,"ATL","TB",24,31,-7,"2016"
"4222","2016_02_ATL_OAK",2016-09-18,"LV","ATL",28,35,-7,"2016"
"4223","2016_02_BAL_CLE",2016-09-18,"CLE","BAL",20,25,-5,"2016"
"4224","2016_02_CIN_PIT",2016-09-18,"PIT","CIN",24,16,8,"2016"
"4225","2016_02_DAL_WAS",2016-09-18,"WAS","DAL",23,27,-4,"2016"
"4226","2016_02_GB_MIN",2016-09-18,"MIN","GB",17,14,3,"2016"
"4227","2016_02_IND_DEN",2016-09-18,"DEN","IND",34,20,14,"2016"
"4228","2016_02_JAX_SD",2016-09-18,"LAC","JAX",38,14,24,"2016"
"4229","2016_02_KC_HOU",2016-09-18,"HOU","KC",19,12,7,"2016"
"4230","2016_02_MIA_NE",2016-09-18,"NE","MIA",31,24,7,"2016"
"4231","2016_02_NO_NYG",2016-09-18,"NYG","NO",16,13,3,"2016"
"4232","2016_02_NYJ_BUF",2016-09-15,"BUF","NYJ",31,37,-6,"2016"
"4233","2016_02_PHI_CHI",2016-09-19,"CHI","PHI",14,29,-15,"2016"
"4234","2016_02_SEA_LA",2016-09-18,"LA","SEA",9,3,6,"2016"
"4235","2016_02_SF_CAR",2016-09-18,"CAR","SF",46,27,19,"2016"
"4236","2016_02_TB_ARI",2016-09-18,"ARI","TB",40,7,33,"2016"
"4237","2016_02_TEN_DET",2016-09-18,"DET","TEN",15,16,-1,"2016"
"4238","2016_03_ARI_BUF",2016-09-25,"BUF","ARI",33,18,15,"2016"
"4239","2016_03_ATL_NO",2016-09-26,"NO","ATL",32,45,-13,"2016"
"4240","2016_03_BAL_JAX",2016-09-25,"JAX","BAL",17,19,-2,"2016"
"4241","2016_03_CHI_DAL",2016-09-25,"DAL","CHI",31,17,14,"2016"
"4242","2016_03_CLE_MIA",2016-09-25,"MIA","CLE",30,24,6,"2016"
"4243","2016_03_DEN_CIN",2016-09-25,"CIN","DEN",17,29,-12,"2016"
"4244","2016_03_DET_GB",2016-09-25,"GB","DET",34,27,7,"2016"
"4245","2016_03_HOU_NE",2016-09-22,"NE","HOU",27,0,27,"2016"
"4246","2016_03_LA_TB",2016-09-25,"TB","LA",32,37,-5,"2016"
"4247","2016_03_MIN_CAR",2016-09-25,"CAR","MIN",10,22,-12,"2016"
"4248","2016_03_NYJ_KC",2016-09-25,"KC","NYJ",24,3,21,"2016"
"4249","2016_03_OAK_TEN",2016-09-25,"TEN","LV",10,17,-7,"2016"
"4250","2016_03_PIT_PHI",2016-09-25,"PHI","PIT",34,3,31,"2016"
"4251","2016_03_SD_IND",2016-09-25,"IND","LAC",26,22,4,"2016"
"4252","2016_03_SF_SEA",2016-09-25,"SEA","SF",37,18,19,"2016"
"4253","2016_03_WAS_NYG",2016-09-25,"NYG","WAS",27,29,-2,"2016"
"4254","2016_04_BUF_NE",2016-10-02,"NE","BUF",0,16,-16,"2016"
"4255","2016_04_CAR_ATL",2016-10-02,"ATL","CAR",48,33,15,"2016"
"4256","2016_04_CLE_WAS",2016-10-02,"WAS","CLE",31,20,11,"2016"
"4257","2016_04_DAL_SF",2016-10-02,"SF","DAL",17,24,-7,"2016"
"4258","2016_04_DEN_TB",2016-10-02,"TB","DEN",7,27,-20,"2016"
"4259","2016_04_DET_CHI",2016-10-02,"CHI","DET",17,14,3,"2016"
"4260","2016_04_IND_JAX",2016-10-02,"JAX","IND",30,27,3,"2016"
"4261","2016_04_KC_PIT",2016-10-02,"PIT","KC",43,14,29,"2016"
"4262","2016_04_LA_ARI",2016-10-02,"ARI","LA",13,17,-4,"2016"
"4263","2016_04_MIA_CIN",2016-09-29,"CIN","MIA",22,7,15,"2016"
"4264","2016_04_NO_SD",2016-10-02,"LAC","NO",34,35,-1,"2016"
"4265","2016_04_NYG_MIN",2016-10-03,"MIN","NYG",24,10,14,"2016"
"4266","2016_04_OAK_BAL",2016-10-02,"BAL","LV",27,28,-1,"2016"
"4267","2016_04_SEA_NYJ",2016-10-02,"NYJ","SEA",17,27,-10,"2016"
"4268","2016_04_TEN_HOU",2016-10-02,"HOU","TEN",27,20,7,"2016"
"4269","2016_05_ARI_SF",2016-10-06,"SF","ARI",21,33,-12,"2016"
"4270","2016_05_ATL_DEN",2016-10-09,"DEN","ATL",16,23,-7,"2016"
"4271","2016_05_BUF_LA",2016-10-09,"LA","BUF",19,30,-11,"2016"
"4272","2016_05_CHI_IND",2016-10-09,"IND","CHI",29,23,6,"2016"
"4273","2016_05_CIN_DAL",2016-10-09,"DAL","CIN",28,14,14,"2016"
"4274","2016_05_HOU_MIN",2016-10-09,"MIN","HOU",31,13,18,"2016"
"4275","2016_05_NE_CLE",2016-10-09,"CLE","NE",13,33,-20,"2016"
"4276","2016_05_NYG_GB",2016-10-09,"GB","NYG",23,16,7,"2016"
"4277","2016_05_NYJ_PIT",2016-10-09,"PIT","NYJ",31,13,18,"2016"
"4278","2016_05_PHI_DET",2016-10-09,"DET","PHI",24,23,1,"2016"
"4279","2016_05_SD_OAK",2016-10-09,"LV","LAC",34,31,3,"2016"
"4280","2016_05_TB_CAR",2016-10-10,"CAR","TB",14,17,-3,"2016"
"4281","2016_05_TEN_MIA",2016-10-09,"MIA","TEN",17,30,-13,"2016"
"4282","2016_05_WAS_BAL",2016-10-09,"BAL","WAS",10,16,-6,"2016"
"4283","2016_06_ATL_SEA",2016-10-16,"SEA","ATL",26,24,2,"2016"
"4284","2016_06_BAL_NYG",2016-10-16,"NYG","BAL",27,23,4,"2016"
"4285","2016_06_CAR_NO",2016-10-16,"NO","CAR",41,38,3,"2016"
"4286","2016_06_CIN_NE",2016-10-16,"NE","CIN",35,17,18,"2016"
"4287","2016_06_CLE_TEN",2016-10-16,"TEN","CLE",28,26,2,"2016"
"4288","2016_06_DAL_GB",2016-10-16,"GB","DAL",16,30,-14,"2016"
"4289","2016_06_DEN_SD",2016-10-13,"LAC","DEN",21,13,8,"2016"
"4290","2016_06_IND_HOU",2016-10-16,"HOU","IND",26,23,3,"2016"
"4291","2016_06_JAX_CHI",2016-10-16,"CHI","JAX",16,17,-1,"2016"
"4292","2016_06_KC_OAK",2016-10-16,"LV","KC",10,26,-16,"2016"
"4293","2016_06_LA_DET",2016-10-16,"DET","LA",31,28,3,"2016"
"4294","2016_06_NYJ_ARI",2016-10-17,"ARI","NYJ",28,3,25,"2016"
"4295","2016_06_PHI_WAS",2016-10-16,"WAS","PHI",27,20,7,"2016"
"4296","2016_06_PIT_MIA",2016-10-16,"MIA","PIT",30,15,15,"2016"
"4297","2016_06_SF_BUF",2016-10-16,"BUF","SF",45,16,29,"2016"
"4298","2016_07_BAL_NYJ",2016-10-23,"NYJ","BAL",24,16,8,"2016"
"4299","2016_07_BUF_MIA",2016-10-23,"MIA","BUF",28,25,3,"2016"
"4300","2016_07_CHI_GB",2016-10-20,"GB","CHI",26,10,16,"2016"
"4301","2016_07_CLE_CIN",2016-10-23,"CIN","CLE",31,17,14,"2016"
"4302","2016_07_HOU_DEN",2016-10-24,"DEN","HOU",27,9,18,"2016"
"4303","2016_07_IND_TEN",2016-10-23,"TEN","IND",26,34,-8,"2016"
"4304","2016_07_MIN_PHI",2016-10-23,"PHI","MIN",21,10,11,"2016"
"4305","2016_07_NE_PIT",2016-10-23,"PIT","NE",16,27,-11,"2016"
"4306","2016_07_NO_KC",2016-10-23,"KC","NO",27,21,6,"2016"
"4307","2016_07_NYG_LA",2016-10-23,"LA","NYG",10,17,-7,"2016"
"4308","2016_07_OAK_JAX",2016-10-23,"JAX","LV",16,33,-17,"2016"
"4309","2016_07_SD_ATL",2016-10-23,"ATL","LAC",30,33,-3,"2016"
"4310","2016_07_SEA_ARI",2016-10-23,"ARI","SEA",6,6,0,"2016"
"4311","2016_07_TB_SF",2016-10-23,"SF","TB",17,34,-17,"2016"
"4312","2016_07_WAS_DET",2016-10-23,"DET","WAS",20,17,3,"2016"
"4313","2016_08_ARI_CAR",2016-10-30,"CAR","ARI",30,20,10,"2016"
"4314","2016_08_DET_HOU",2016-10-30,"HOU","DET",20,13,7,"2016"
"4315","2016_08_GB_ATL",2016-10-30,"ATL","GB",33,32,1,"2016"
"4316","2016_08_JAX_TEN",2016-10-27,"TEN","JAX",36,22,14,"2016"
"4317","2016_08_KC_IND",2016-10-30,"IND","KC",14,30,-16,"2016"
"4318","2016_08_MIN_CHI",2016-10-31,"CHI","MIN",20,10,10,"2016"
"4319","2016_08_NE_BUF",2016-10-30,"BUF","NE",25,41,-16,"2016"
"4320","2016_08_NYJ_CLE",2016-10-30,"CLE","NYJ",28,31,-3,"2016"
"4321","2016_08_OAK_TB",2016-10-30,"TB","LV",24,30,-6,"2016"
"4322","2016_08_PHI_DAL",2016-10-30,"DAL","PHI",29,23,6,"2016"
"4323","2016_08_SD_DEN",2016-10-30,"DEN","LAC",27,19,8,"2016"
"4324","2016_08_SEA_NO",2016-10-30,"NO","SEA",25,20,5,"2016"
"4325","2016_08_WAS_CIN",2016-10-30,"CIN","WAS",27,27,0,"2016"
"4326","2016_09_ATL_TB",2016-11-03,"TB","ATL",28,43,-15,"2016"
"4327","2016_09_BUF_SEA",2016-11-07,"SEA","BUF",31,25,6,"2016"
"4328","2016_09_CAR_LA",2016-11-06,"LA","CAR",10,13,-3,"2016"
"4329","2016_09_DAL_CLE",2016-11-06,"CLE","DAL",10,35,-25,"2016"
"4330","2016_09_DEN_OAK",2016-11-06,"LV","DEN",30,20,10,"2016"
"4331","2016_09_DET_MIN",2016-11-06,"MIN","DET",16,22,-6,"2016"
"4332","2016_09_IND_GB",2016-11-06,"GB","IND",26,31,-5,"2016"
"4333","2016_09_JAX_KC",2016-11-06,"KC","JAX",19,14,5,"2016"
"4334","2016_09_NO_SF",2016-11-06,"SF","NO",23,41,-18,"2016"
"4335","2016_09_NYJ_MIA",2016-11-06,"MIA","NYJ",27,23,4,"2016"
"4336","2016_09_PHI_NYG",2016-11-06,"NYG","PHI",28,23,5,"2016"
"4337","2016_09_PIT_BAL",2016-11-06,"BAL","PIT",21,14,7,"2016"
"4338","2016_09_TEN_SD",2016-11-06,"LAC","TEN",43,35,8,"2016"
"4339","2016_10_ATL_PHI",2016-11-13,"PHI","ATL",24,15,9,"2016"
"4340","2016_10_CHI_TB",2016-11-13,"TB","CHI",36,10,26,"2016"
"4341","2016_10_CIN_NYG",2016-11-14,"NYG","CIN",21,20,1,"2016"
"4342","2016_10_CLE_BAL",2016-11-10,"BAL","CLE",28,7,21,"2016"
"4343","2016_10_DAL_PIT",2016-11-13,"PIT","DAL",30,35,-5,"2016"
"4344","2016_10_DEN_NO",2016-11-13,"NO","DEN",23,25,-2,"2016"
"4345","2016_10_GB_TEN",2016-11-13,"TEN","GB",47,25,22,"2016"
"4346","2016_10_HOU_JAX",2016-11-13,"JAX","HOU",21,24,-3,"2016"
"4347","2016_10_KC_CAR",2016-11-13,"CAR","KC",17,20,-3,"2016"
"4348","2016_10_LA_NYJ",2016-11-13,"NYJ","LA",6,9,-3,"2016"
"4349","2016_10_MIA_SD",2016-11-13,"LAC","MIA",24,31,-7,"2016"
"4350","2016_10_MIN_WAS",2016-11-13,"WAS","MIN",26,20,6,"2016"
"4351","2016_10_SEA_NE",2016-11-13,"NE","SEA",24,31,-7,"2016"
"4352","2016_10_SF_ARI",2016-11-13,"ARI","SF",23,20,3,"2016"
"4353","2016_11_ARI_MIN",2016-11-20,"MIN","ARI",30,24,6,"2016"
"4354","2016_11_BAL_DAL",2016-11-20,"DAL","BAL",27,17,10,"2016"
"4355","2016_11_BUF_CIN",2016-11-20,"CIN","BUF",12,16,-4,"2016"
"4356","2016_11_CHI_NYG",2016-11-20,"NYG","CHI",22,16,6,"2016"
"4357","2016_11_GB_WAS",2016-11-20,"WAS","GB",42,24,18,"2016"
"4358","2016_11_HOU_OAK",2016-11-21,"LV","HOU",27,20,7,"2016"
"4359","2016_11_JAX_DET",2016-11-20,"DET","JAX",26,19,7,"2016"
"4360","2016_11_MIA_LA",2016-11-20,"LA","MIA",10,14,-4,"2016"
"4361","2016_11_NE_SF",2016-11-20,"SF","NE",17,30,-13,"2016"
"4362","2016_11_NO_CAR",2016-11-17,"CAR","NO",23,20,3,"2016"
"4363","2016_11_PHI_SEA",2016-11-20,"SEA","PHI",26,15,11,"2016"
"4364","2016_11_PIT_CLE",2016-11-20,"CLE","PIT",9,24,-15,"2016"
"4365","2016_11_TB_KC",2016-11-20,"KC","TB",17,19,-2,"2016"
"4366","2016_11_TEN_IND",2016-11-20,"IND","TEN",24,17,7,"2016"
"4367","2016_12_ARI_ATL",2016-11-27,"ATL","ARI",38,19,19,"2016"
"4368","2016_12_CAR_OAK",2016-11-27,"LV","CAR",35,32,3,"2016"
"4369","2016_12_CIN_BAL",2016-11-27,"BAL","CIN",19,14,5,"2016"
"4370","2016_12_GB_PHI",2016-11-28,"PHI","GB",13,27,-14,"2016"
"4371","2016_12_JAX_BUF",2016-11-27,"BUF","JAX",28,21,7,"2016"
"4372","2016_12_KC_DEN",2016-11-27,"DEN","KC",27,30,-3,"2016"
"4373","2016_12_LA_NO",2016-11-27,"NO","LA",49,21,28,"2016"
"4374","2016_12_MIN_DET",2016-11-24,"DET","MIN",16,13,3,"2016"
"4375","2016_12_NE_NYJ",2016-11-27,"NYJ","NE",17,22,-5,"2016"
"4376","2016_12_NYG_CLE",2016-11-27,"CLE","NYG",13,27,-14,"2016"
"4377","2016_12_PIT_IND",2016-11-24,"IND","PIT",7,28,-21,"2016"
"4378","2016_12_SD_HOU",2016-11-27,"HOU","LAC",13,21,-8,"2016"
"4379","2016_12_SEA_TB",2016-11-27,"TB","SEA",14,5,9,"2016"
"4380","2016_12_SF_MIA",2016-11-27,"MIA","SF",31,24,7,"2016"
"4381","2016_12_TEN_CHI",2016-11-27,"CHI","TEN",21,27,-6,"2016"
"4382","2016_12_WAS_DAL",2016-11-24,"DAL","WAS",31,26,5,"2016"
"4383","2016_13_BUF_OAK",2016-12-04,"LV","BUF",38,24,14,"2016"
"4384","2016_13_CAR_SEA",2016-12-04,"SEA","CAR",40,7,33,"2016"
"4385","2016_13_DAL_MIN",2016-12-01,"MIN","DAL",15,17,-2,"2016"
"4386","2016_13_DEN_JAX",2016-12-04,"JAX","DEN",10,20,-10,"2016"
"4387","2016_13_DET_NO",2016-12-04,"NO","DET",13,28,-15,"2016"
"4388","2016_13_HOU_GB",2016-12-04,"GB","HOU",21,13,8,"2016"
"4389","2016_13_IND_NYJ",2016-12-05,"NYJ","IND",10,41,-31,"2016"
"4390","2016_13_KC_ATL",2016-12-04,"ATL","KC",28,29,-1,"2016"
"4391","2016_13_LA_NE",2016-12-04,"NE","LA",26,10,16,"2016"
"4392","2016_13_MIA_BAL",2016-12-04,"BAL","MIA",38,6,32,"2016"
"4393","2016_13_NYG_PIT",2016-12-04,"PIT","NYG",24,14,10,"2016"
"4394","2016_13_PHI_CIN",2016-12-04,"CIN","PHI",32,14,18,"2016"
"4395","2016_13_SF_CHI",2016-12-04,"CHI","SF",26,6,20,"2016"
"4396","2016_13_TB_SD",2016-12-04,"LAC","TB",21,28,-7,"2016"
"4397","2016_13_WAS_ARI",2016-12-04,"ARI","WAS",31,23,8,"2016"
"4398","2016_14_ARI_MIA",2016-12-11,"MIA","ARI",26,23,3,"2016"
"4399","2016_14_ATL_LA",2016-12-11,"LA","ATL",14,42,-28,"2016"
"4400","2016_14_BAL_NE",2016-12-12,"NE","BAL",30,23,7,"2016"
"4401","2016_14_CHI_DET",2016-12-11,"DET","CHI",20,17,3,"2016"
"4402","2016_14_CIN_CLE",2016-12-11,"CLE","CIN",10,23,-13,"2016"
"4403","2016_14_DAL_NYG",2016-12-11,"NYG","DAL",10,7,3,"2016"
"4404","2016_14_DEN_TEN",2016-12-11,"TEN","DEN",13,10,3,"2016"
"4405","2016_14_HOU_IND",2016-12-11,"IND","HOU",17,22,-5,"2016"
"4406","2016_14_MIN_JAX",2016-12-11,"JAX","MIN",16,25,-9,"2016"
"4407","2016_14_NO_TB",2016-12-11,"TB","NO",16,11,5,"2016"
"4408","2016_14_NYJ_SF",2016-12-11,"SF","NYJ",17,23,-6,"2016"
"4409","2016_14_OAK_KC",2016-12-08,"KC","LV",21,13,8,"2016"
"4410","2016_14_PIT_BUF",2016-12-11,"BUF","PIT",20,27,-7,"2016"
"4411","2016_14_SD_CAR",2016-12-11,"CAR","LAC",28,16,12,"2016"
"4412","2016_14_SEA_GB",2016-12-11,"GB","SEA",38,10,28,"2016"
"4413","2016_14_WAS_PHI",2016-12-11,"PHI","WAS",22,27,-5,"2016"
"4414","2016_15_CAR_WAS",2016-12-19,"WAS","CAR",15,26,-11,"2016"
"4415","2016_15_CLE_BUF",2016-12-18,"BUF","CLE",33,13,20,"2016"
"4416","2016_15_DET_NYG",2016-12-18,"NYG","DET",17,6,11,"2016"
"4417","2016_15_GB_CHI",2016-12-18,"CHI","GB",27,30,-3,"2016"
"4418","2016_15_IND_MIN",2016-12-18,"MIN","IND",6,34,-28,"2016"
"4419","2016_15_JAX_HOU",2016-12-18,"HOU","JAX",21,20,1,"2016"
"4420","2016_15_LA_SEA",2016-12-15,"SEA","LA",24,3,21,"2016"
"4421","2016_15_MIA_NYJ",2016-12-17,"NYJ","MIA",13,34,-21,"2016"
"4422","2016_15_NE_DEN",2016-12-18,"DEN","NE",3,16,-13,"2016"
"4423","2016_15_NO_ARI",2016-12-18,"ARI","NO",41,48,-7,"2016"
"4424","2016_15_OAK_SD",2016-12-18,"LAC","LV",16,19,-3,"2016"
"4425","2016_15_PHI_BAL",2016-12-18,"BAL","PHI",27,26,1,"2016"
"4426","2016_15_PIT_CIN",2016-12-18,"CIN","PIT",20,24,-4,"2016"
"4427","2016_15_SF_ATL",2016-12-18,"ATL","SF",41,13,28,"2016"
"4428","2016_15_TB_DAL",2016-12-18,"DAL","TB",26,20,6,"2016"
"4429","2016_15_TEN_KC",2016-12-18,"KC","TEN",17,19,-2,"2016"
"4430","2016_16_ARI_SEA",2016-12-24,"SEA","ARI",31,34,-3,"2016"
"4431","2016_16_ATL_CAR",2016-12-24,"CAR","ATL",16,33,-17,"2016"
"4432","2016_16_BAL_PIT",2016-12-25,"PIT","BAL",31,27,4,"2016"
"4433","2016_16_CIN_HOU",2016-12-24,"HOU","CIN",12,10,2,"2016"
"4434","2016_16_DEN_KC",2016-12-25,"KC","DEN",33,10,23,"2016"
"4435","2016_16_DET_DAL",2016-12-26,"DAL","DET",42,21,21,"2016"
"4436","2016_16_IND_OAK",2016-12-24,"LV","IND",33,25,8,"2016"
"4437","2016_16_MIA_BUF",2016-12-24,"BUF","MIA",31,34,-3,"2016"
"4438","2016_16_MIN_GB",2016-12-24,"GB","MIN",38,25,13,"2016"
"4439","2016_16_NYG_PHI",2016-12-22,"PHI","NYG",24,19,5,"2016"
"4440","2016_16_NYJ_NE",2016-12-24,"NE","NYJ",41,3,38,"2016"
"4441","2016_16_SD_CLE",2016-12-24,"CLE","LAC",20,17,3,"2016"
"4442","2016_16_SF_LA",2016-12-24,"LA","SF",21,22,-1,"2016"
"4443","2016_16_TB_NO",2016-12-24,"NO","TB",31,24,7,"2016"
"4444","2016_16_TEN_JAX",2016-12-24,"JAX","TEN",38,17,21,"2016"
"4445","2016_16_WAS_CHI",2016-12-24,"CHI","WAS",21,41,-20,"2016"
"4446","2017_01_ARI_DET",2017-09-10,"DET","ARI",35,23,12,"2017"
"4447","2017_01_ATL_CHI",2017-09-10,"CHI","ATL",17,23,-6,"2017"
"4448","2017_01_BAL_CIN",2017-09-10,"CIN","BAL",0,20,-20,"2017"
"4449","2017_01_CAR_SF",2017-09-10,"SF","CAR",3,23,-20,"2017"
"4450","2017_01_IND_LA",2017-09-10,"LA","IND",46,9,37,"2017"
"4451","2017_01_JAX_HOU",2017-09-10,"HOU","JAX",7,29,-22,"2017"
"4452","2017_01_KC_NE",2017-09-07,"NE","KC",27,42,-15,"2017"
"4453","2017_01_LAC_DEN",2017-09-11,"DEN","LAC",24,21,3,"2017"
"4454","2017_01_NO_MIN",2017-09-11,"MIN","NO",29,19,10,"2017"
"4455","2017_01_NYG_DAL",2017-09-10,"DAL","NYG",19,3,16,"2017"
"4456","2017_01_NYJ_BUF",2017-09-10,"BUF","NYJ",21,12,9,"2017"
"4457","2017_01_OAK_TEN",2017-09-10,"TEN","LV",16,26,-10,"2017"
"4458","2017_01_PHI_WAS",2017-09-10,"WAS","PHI",17,30,-13,"2017"
"4459","2017_01_PIT_CLE",2017-09-10,"CLE","PIT",18,21,-3,"2017"
"4460","2017_01_SEA_GB",2017-09-10,"GB","SEA",17,9,8,"2017"
"4461","2017_02_ARI_IND",2017-09-17,"IND","ARI",13,16,-3,"2017"
"4462","2017_02_BUF_CAR",2017-09-17,"CAR","BUF",9,3,6,"2017"
"4463","2017_02_CHI_TB",2017-09-17,"TB","CHI",29,7,22,"2017"
"4464","2017_02_CLE_BAL",2017-09-17,"BAL","CLE",24,10,14,"2017"
"4465","2017_02_DAL_DEN",2017-09-17,"DEN","DAL",42,17,25,"2017"
"4466","2017_02_DET_NYG",2017-09-18,"NYG","DET",10,24,-14,"2017"
"4467","2017_02_GB_ATL",2017-09-17,"ATL","GB",34,23,11,"2017"
"4468","2017_02_HOU_CIN",2017-09-14,"CIN","HOU",9,13,-4,"2017"
"4469","2017_02_MIA_LAC",2017-09-17,"LAC","MIA",17,19,-2,"2017"
"4470","2017_02_MIN_PIT",2017-09-17,"PIT","MIN",26,9,17,"2017"
"4471","2017_02_NE_NO",2017-09-17,"NO","NE",20,36,-16,"2017"
"4472","2017_02_NYJ_OAK",2017-09-17,"LV","NYJ",45,20,25,"2017"
"4473","2017_02_PHI_KC",2017-09-17,"KC","PHI",27,20,7,"2017"
"4474","2017_02_SF_SEA",2017-09-17,"SEA","SF",12,9,3,"2017"
"4475","2017_02_TEN_JAX",2017-09-17,"JAX","TEN",16,37,-21,"2017"
"4476","2017_02_WAS_LA",2017-09-17,"LA","WAS",20,27,-7,"2017"
"4477","2017_03_ATL_DET",2017-09-24,"DET","ATL",26,30,-4,"2017"
"4478","2017_03_BAL_JAX",2017-09-24,"JAX","BAL",44,7,37,"2017"
"4479","2017_03_CIN_GB",2017-09-24,"GB","CIN",27,24,3,"2017"
"4480","2017_03_CLE_IND",2017-09-24,"IND","CLE",31,28,3,"2017"
"4481","2017_03_DAL_ARI",2017-09-25,"ARI","DAL",17,28,-11,"2017"
"4482","2017_03_DEN_BUF",2017-09-24,"BUF","DEN",26,16,10,"2017"
"4483","2017_03_HOU_NE",2017-09-24,"NE","HOU",36,33,3,"2017"
"4484","2017_03_KC_LAC",2017-09-24,"LAC","KC",10,24,-14,"2017"
"4485","2017_03_LA_SF",2017-09-21,"SF","LA",39,41,-2,"2017"
"4486","2017_03_MIA_NYJ",2017-09-24,"NYJ","MIA",20,6,14,"2017"
"4487","2017_03_NO_CAR",2017-09-24,"CAR","NO",13,34,-21,"2017"
"4488","2017_03_NYG_PHI",2017-09-24,"PHI","NYG",27,24,3,"2017"
"4489","2017_03_OAK_WAS",2017-09-24,"WAS","LV",27,10,17,"2017"
"4490","2017_03_PIT_CHI",2017-09-24,"CHI","PIT",23,17,6,"2017"
"4491","2017_03_SEA_TEN",2017-09-24,"TEN","SEA",33,27,6,"2017"
"4492","2017_03_TB_MIN",2017-09-24,"MIN","TB",34,17,17,"2017"
"4493","2017_04_BUF_ATL",2017-10-01,"ATL","BUF",17,23,-6,"2017"
"4494","2017_04_CAR_NE",2017-10-01,"NE","CAR",30,33,-3,"2017"
"4495","2017_04_CHI_GB",2017-09-28,"GB","CHI",35,14,21,"2017"
"4496","2017_04_CIN_CLE",2017-10-01,"CLE","CIN",7,31,-24,"2017"
"4497","2017_04_DET_MIN",2017-10-01,"MIN","DET",7,14,-7,"2017"
"4498","2017_04_IND_SEA",2017-10-01,"SEA","IND",46,18,28,"2017"
"4499","2017_04_JAX_NYJ",2017-10-01,"NYJ","JAX",23,20,3,"2017"
"4500","2017_04_LA_DAL",2017-10-01,"DAL","LA",30,35,-5,"2017"
"4501","2017_04_NO_MIA",2017-10-01,"MIA","NO",0,20,-20,"2017"
"4502","2017_04_NYG_TB",2017-10-01,"TB","NYG",25,23,2,"2017"
"4503","2017_04_OAK_DEN",2017-10-01,"DEN","LV",16,10,6,"2017"
"4504","2017_04_PHI_LAC",2017-10-01,"LAC","PHI",24,26,-2,"2017"
"4505","2017_04_PIT_BAL",2017-10-01,"BAL","PIT",9,26,-17,"2017"
"4506","2017_04_SF_ARI",2017-10-01,"ARI","SF",18,15,3,"2017"
"4507","2017_04_TEN_HOU",2017-10-01,"HOU","TEN",57,14,43,"2017"
"4508","2017_04_WAS_KC",2017-10-02,"KC","WAS",29,20,9,"2017"
"4509","2017_05_ARI_PHI",2017-10-08,"PHI","ARI",34,7,27,"2017"
"4510","2017_05_BAL_OAK",2017-10-08,"LV","BAL",17,30,-13,"2017"
"4511","2017_05_BUF_CIN",2017-10-08,"CIN","BUF",20,16,4,"2017"
"4512","2017_05_CAR_DET",2017-10-08,"DET","CAR",24,27,-3,"2017"
"4513","2017_05_GB_DAL",2017-10-08,"DAL","GB",31,35,-4,"2017"
"4514","2017_05_JAX_PIT",2017-10-08,"PIT","JAX",9,30,-21,"2017"
"4515","2017_05_KC_HOU",2017-10-08,"HOU","KC",34,42,-8,"2017"
"4516","2017_05_LAC_NYG",2017-10-08,"NYG","LAC",22,27,-5,"2017"
"4517","2017_05_MIN_CHI",2017-10-09,"CHI","MIN",17,20,-3,"2017"
"4518","2017_05_NE_TB",2017-10-05,"TB","NE",14,19,-5,"2017"
"4519","2017_05_NYJ_CLE",2017-10-08,"CLE","NYJ",14,17,-3,"2017"
"4520","2017_05_SEA_LA",2017-10-08,"LA","SEA",10,16,-6,"2017"
"4521","2017_05_SF_IND",2017-10-08,"IND","SF",26,23,3,"2017"
"4522","2017_05_TEN_MIA",2017-10-08,"MIA","TEN",16,10,6,"2017"
"4523","2017_06_CHI_BAL",2017-10-15,"BAL","CHI",24,27,-3,"2017"
"4524","2017_06_CLE_HOU",2017-10-15,"HOU","CLE",33,17,16,"2017"
"4525","2017_06_DET_NO",2017-10-15,"NO","DET",52,38,14,"2017"
"4526","2017_06_GB_MIN",2017-10-15,"MIN","GB",23,10,13,"2017"
"4527","2017_06_IND_TEN",2017-10-16,"TEN","IND",36,22,14,"2017"
"4528","2017_06_LAC_OAK",2017-10-15,"LV","LAC",16,17,-1,"2017"
"4529","2017_06_LA_JAX",2017-10-15,"JAX","LA",17,27,-10,"2017"
"4530","2017_06_MIA_ATL",2017-10-15,"ATL","MIA",17,20,-3,"2017"
"4531","2017_06_NE_NYJ",2017-10-15,"NYJ","NE",17,24,-7,"2017"
"4532","2017_06_NYG_DEN",2017-10-15,"DEN","NYG",10,23,-13,"2017"
"4533","2017_06_PHI_CAR",2017-10-12,"CAR","PHI",23,28,-5,"2017"
"4534","2017_06_PIT_KC",2017-10-15,"KC","PIT",13,19,-6,"2017"
"4535","2017_06_SF_WAS",2017-10-15,"WAS","SF",26,24,2,"2017"
"4536","2017_06_TB_ARI",2017-10-15,"ARI","TB",38,33,5,"2017"
"4537","2017_07_ARI_LA",2017-10-22,"LA","ARI",33,0,33,"2017"
"4538","2017_07_ATL_NE",2017-10-22,"NE","ATL",23,7,16,"2017"
"4539","2017_07_BAL_MIN",2017-10-22,"MIN","BAL",24,16,8,"2017"
"4540","2017_07_CAR_CHI",2017-10-22,"CHI","CAR",17,3,14,"2017"
"4541","2017_07_CIN_PIT",2017-10-22,"PIT","CIN",29,14,15,"2017"
"4542","2017_07_DAL_SF",2017-10-22,"SF","DAL",10,40,-30,"2017"
"4543","2017_07_DEN_LAC",2017-10-22,"LAC","DEN",21,0,21,"2017"
"4544","2017_07_JAX_IND",2017-10-22,"IND","JAX",0,27,-27,"2017"
"4545","2017_07_KC_OAK",2017-10-19,"LV","KC",31,30,1,"2017"
"4546","2017_07_NO_GB",2017-10-22,"GB","NO",17,26,-9,"2017"
"4547","2017_07_NYJ_MIA",2017-10-22,"MIA","NYJ",31,28,3,"2017"
"4548","2017_07_SEA_NYG",2017-10-22,"NYG","SEA",7,24,-17,"2017"
"4549","2017_07_TB_BUF",2017-10-22,"BUF","TB",30,27,3,"2017"
"4550","2017_07_TEN_CLE",2017-10-22,"CLE","TEN",9,12,-3,"2017"
"4551","2017_07_WAS_PHI",2017-10-23,"PHI","WAS",34,24,10,"2017"
"4552","2017_08_ATL_NYJ",2017-10-29,"NYJ","ATL",20,25,-5,"2017"
"4553","2017_08_CAR_TB",2017-10-29,"TB","CAR",3,17,-14,"2017"
"4554","2017_08_CHI_NO",2017-10-29,"NO","CHI",20,12,8,"2017"
"4555","2017_08_DAL_WAS",2017-10-29,"WAS","DAL",19,33,-14,"2017"
"4556","2017_08_DEN_KC",2017-10-30,"KC","DEN",29,19,10,"2017"
"4557","2017_08_HOU_SEA",2017-10-29,"SEA","HOU",41,38,3,"2017"
"4558","2017_08_IND_CIN",2017-10-29,"CIN","IND",24,23,1,"2017"
"4559","2017_08_LAC_NE",2017-10-29,"NE","LAC",21,13,8,"2017"
"4560","2017_08_MIA_BAL",2017-10-26,"BAL","MIA",40,0,40,"2017"
"4561","2017_08_MIN_CLE",2017-10-29,"CLE","MIN",16,33,-17,"2017"
"4562","2017_08_OAK_BUF",2017-10-29,"BUF","LV",34,14,20,"2017"
"4563","2017_08_PIT_DET",2017-10-29,"DET","PIT",15,20,-5,"2017"
"4564","2017_08_SF_PHI",2017-10-29,"PHI","SF",33,10,23,"2017"
"4565","2017_09_ARI_SF",2017-11-05,"SF","ARI",10,20,-10,"2017"
"4566","2017_09_ATL_CAR",2017-11-05,"CAR","ATL",20,17,3,"2017"
"4567","2017_09_BAL_TEN",2017-11-05,"TEN","BAL",23,20,3,"2017"
"4568","2017_09_BUF_NYJ",2017-11-02,"NYJ","BUF",34,21,13,"2017"
"4569","2017_09_CIN_JAX",2017-11-05,"JAX","CIN",23,7,16,"2017"
"4570","2017_09_DEN_PHI",2017-11-05,"PHI","DEN",51,23,28,"2017"
"4571","2017_09_DET_GB",2017-11-06,"GB","DET",17,30,-13,"2017"
"4572","2017_09_IND_HOU",2017-11-05,"HOU","IND",14,20,-6,"2017"
"4573","2017_09_KC_DAL",2017-11-05,"DAL","KC",28,17,11,"2017"
"4574","2017_09_LA_NYG",2017-11-05,"NYG","LA",17,51,-34,"2017"
"4575","2017_09_OAK_MIA",2017-11-05,"MIA","LV",24,27,-3,"2017"
"4576","2017_09_TB_NO",2017-11-05,"NO","TB",30,10,20,"2017"
"4577","2017_09_WAS_SEA",2017-11-05,"SEA","WAS",14,17,-3,"2017"
"4578","2017_10_CIN_TEN",2017-11-12,"TEN","CIN",24,20,4,"2017"
"4579","2017_10_CLE_DET",2017-11-12,"DET","CLE",38,24,14,"2017"
"4580","2017_10_DAL_ATL",2017-11-12,"ATL","DAL",27,7,20,"2017"
"4581","2017_10_GB_CHI",2017-11-12,"CHI","GB",16,23,-7,"2017"
"4582","2017_10_HOU_LA",2017-11-12,"LA","HOU",33,7,26,"2017"
"4583","2017_10_LAC_JAX",2017-11-12,"JAX","LAC",20,17,3,"2017"
"4584","2017_10_MIA_CAR",2017-11-13,"CAR","MIA",45,21,24,"2017"
"4585","2017_10_MIN_WAS",2017-11-12,"WAS","MIN",30,38,-8,"2017"
"4586","2017_10_NE_DEN",2017-11-12,"DEN","NE",16,41,-25,"2017"
"4587","2017_10_NO_BUF",2017-11-12,"BUF","NO",10,47,-37,"2017"
"4588","2017_10_NYG_SF",2017-11-12,"SF","NYG",31,21,10,"2017"
"4589","2017_10_NYJ_TB",2017-11-12,"TB","NYJ",15,10,5,"2017"
"4590","2017_10_PIT_IND",2017-11-12,"IND","PIT",17,20,-3,"2017"
"4591","2017_10_SEA_ARI",2017-11-09,"ARI","SEA",16,22,-6,"2017"
"4592","2017_11_ARI_HOU",2017-11-19,"HOU","ARI",31,21,10,"2017"
"4593","2017_11_ATL_SEA",2017-11-20,"SEA","ATL",31,34,-3,"2017"
"4594","2017_11_BAL_GB",2017-11-19,"GB","BAL",0,23,-23,"2017"
"4595","2017_11_BUF_LAC",2017-11-19,"LAC","BUF",54,24,30,"2017"
"4596","2017_11_CIN_DEN",2017-11-19,"DEN","CIN",17,20,-3,"2017"
"4597","2017_11_DET_CHI",2017-11-19,"CHI","DET",24,27,-3,"2017"
"4598","2017_11_JAX_CLE",2017-11-19,"CLE","JAX",7,19,-12,"2017"
"4599","2017_11_KC_NYG",2017-11-19,"NYG","KC",12,9,3,"2017"
"4600","2017_11_LA_MIN",2017-11-19,"MIN","LA",24,7,17,"2017"
"4601","2017_11_NE_OAK",2017-11-19,"LV","NE",8,33,-25,"2017"
"4602","2017_11_PHI_DAL",2017-11-19,"DAL","PHI",9,37,-28,"2017"
"4603","2017_11_TB_MIA",2017-11-19,"MIA","TB",20,30,-10,"2017"
"4604","2017_11_TEN_PIT",2017-11-16,"PIT","TEN",40,17,23,"2017"
"4605","2017_11_WAS_NO",2017-11-19,"NO","WAS",34,31,3,"2017"
"4606","2017_12_BUF_KC",2017-11-26,"KC","BUF",10,16,-6,"2017"
"4607","2017_12_CAR_NYJ",2017-11-26,"NYJ","CAR",27,35,-8,"2017"
"4608","2017_12_CHI_PHI",2017-11-26,"PHI","CHI",31,3,28,"2017"
"4609","2017_12_CLE_CIN",2017-11-26,"CIN","CLE",30,16,14,"2017"
"4610","2017_12_DEN_OAK",2017-11-26,"LV","DEN",21,14,7,"2017"
"4611","2017_12_GB_PIT",2017-11-26,"PIT","GB",31,28,3,"2017"
"4612","2017_12_HOU_BAL",2017-11-27,"BAL","HOU",23,16,7,"2017"
"4613","2017_12_JAX_ARI",2017-11-26,"ARI","JAX",27,24,3,"2017"
"4614","2017_12_LAC_DAL",2017-11-23,"DAL","LAC",6,28,-22,"2017"
"4615","2017_12_MIA_NE",2017-11-26,"NE","MIA",35,17,18,"2017"
"4616","2017_12_MIN_DET",2017-11-23,"DET","MIN",23,30,-7,"2017"
"4617","2017_12_NO_LA",2017-11-26,"LA","NO",26,20,6,"2017"
"4618","2017_12_NYG_WAS",2017-11-23,"WAS","NYG",20,10,10,"2017"
"4619","2017_12_SEA_SF",2017-11-26,"SF","SEA",13,24,-11,"2017"
"4620","2017_12_TB_ATL",2017-11-26,"ATL","TB",34,20,14,"2017"
"4621","2017_12_TEN_IND",2017-11-26,"IND","TEN",16,20,-4,"2017"
"4622","2017_13_CAR_NO",2017-12-03,"NO","CAR",31,21,10,"2017"
"4623","2017_13_CLE_LAC",2017-12-03,"LAC","CLE",19,10,9,"2017"
"4624","2017_13_DEN_MIA",2017-12-03,"MIA","DEN",35,9,26,"2017"
"4625","2017_13_DET_BAL",2017-12-03,"BAL","DET",44,20,24,"2017"
"4626","2017_13_HOU_TEN",2017-12-03,"TEN","HOU",24,13,11,"2017"
"4627","2017_13_IND_JAX",2017-12-03,"JAX","IND",30,10,20,"2017"
"4628","2017_13_KC_NYJ",2017-12-03,"NYJ","KC",38,31,7,"2017"
"4629","2017_13_LA_ARI",2017-12-03,"ARI","LA",16,32,-16,"2017"
"4630","2017_13_MIN_ATL",2017-12-03,"ATL","MIN",9,14,-5,"2017"
"4631","2017_13_NE_BUF",2017-12-03,"BUF","NE",3,23,-20,"2017"
"4632","2017_13_NYG_OAK",2017-12-03,"LV","NYG",24,17,7,"2017"
"4633","2017_13_PHI_SEA",2017-12-03,"SEA","PHI",24,10,14,"2017"
"4634","2017_13_PIT_CIN",2017-12-04,"CIN","PIT",20,23,-3,"2017"
"4635","2017_13_SF_CHI",2017-12-03,"CHI","SF",14,15,-1,"2017"
"4636","2017_13_TB_GB",2017-12-03,"GB","TB",26,20,6,"2017"
"4637","2017_13_WAS_DAL",2017-11-30,"DAL","WAS",38,14,24,"2017"
"4638","2017_14_BAL_PIT",2017-12-10,"PIT","BAL",39,38,1,"2017"
"4639","2017_14_CHI_CIN",2017-12-10,"CIN","CHI",7,33,-26,"2017"
"4640","2017_14_DAL_NYG",2017-12-10,"NYG","DAL",10,30,-20,"2017"
"4641","2017_14_DET_TB",2017-12-10,"TB","DET",21,24,-3,"2017"
"4642","2017_14_GB_CLE",2017-12-10,"CLE","GB",21,27,-6,"2017"
"4643","2017_14_IND_BUF",2017-12-10,"BUF","IND",13,7,6,"2017"
"4644","2017_14_MIN_CAR",2017-12-10,"CAR","MIN",31,24,7,"2017"
"4645","2017_14_NE_MIA",2017-12-11,"MIA","NE",27,20,7,"2017"
"4646","2017_14_NO_ATL",2017-12-07,"ATL","NO",20,17,3,"2017"
"4647","2017_14_NYJ_DEN",2017-12-10,"DEN","NYJ",23,0,23,"2017"
"4648","2017_14_OAK_KC",2017-12-10,"KC","LV",26,15,11,"2017"
"4649","2017_14_PHI_LA",2017-12-10,"LA","PHI",35,43,-8,"2017"
"4650","2017_14_SEA_JAX",2017-12-10,"JAX","SEA",30,24,6,"2017"
"4651","2017_14_SF_HOU",2017-12-10,"HOU","SF",16,26,-10,"2017"
"4652","2017_14_TEN_ARI",2017-12-10,"ARI","TEN",12,7,5,"2017"
"4653","2017_14_WAS_LAC",2017-12-10,"LAC","WAS",30,13,17,"2017"
"4654","2017_15_ARI_WAS",2017-12-17,"WAS","ARI",20,15,5,"2017"
"4655","2017_15_ATL_TB",2017-12-18,"TB","ATL",21,24,-3,"2017"
"4656","2017_15_BAL_CLE",2017-12-17,"CLE","BAL",10,27,-17,"2017"
"4657","2017_15_CHI_DET",2017-12-16,"DET","CHI",20,10,10,"2017"
"4658","2017_15_CIN_MIN",2017-12-17,"MIN","CIN",34,7,27,"2017"
"4659","2017_15_DAL_OAK",2017-12-17,"LV","DAL",17,20,-3,"2017"
"4660","2017_15_DEN_IND",2017-12-14,"IND","DEN",13,25,-12,"2017"
"4661","2017_15_GB_CAR",2017-12-17,"CAR","GB",31,24,7,"2017"
"4662","2017_15_HOU_JAX",2017-12-17,"JAX","HOU",45,7,38,"2017"
"4663","2017_15_LAC_KC",2017-12-16,"KC","LAC",30,13,17,"2017"
"4664","2017_15_LA_SEA",2017-12-17,"SEA","LA",7,42,-35,"2017"
"4665","2017_15_MIA_BUF",2017-12-17,"BUF","MIA",24,16,8,"2017"
"4666","2017_15_NE_PIT",2017-12-17,"PIT","NE",24,27,-3,"2017"
"4667","2017_15_NYJ_NO",2017-12-17,"NO","NYJ",31,19,12,"2017"
"4668","2017_15_PHI_NYG",2017-12-17,"NYG","PHI",29,34,-5,"2017"
"4669","2017_15_TEN_SF",2017-12-17,"SF","TEN",25,23,2,"2017"
"4670","2017_16_ATL_NO",2017-12-24,"NO","ATL",23,13,10,"2017"
"4671","2017_16_BUF_NE",2017-12-24,"NE","BUF",37,16,21,"2017"
"4672","2017_16_CLE_CHI",2017-12-24,"CHI","CLE",20,3,17,"2017"
"4673","2017_16_DEN_WAS",2017-12-24,"WAS","DEN",27,11,16,"2017"
"4674","2017_16_DET_CIN",2017-12-24,"CIN","DET",26,17,9,"2017"
"4675","2017_16_IND_BAL",2017-12-23,"BAL","IND",23,16,7,"2017"
"4676","2017_16_JAX_SF",2017-12-24,"SF","JAX",44,33,11,"2017"
"4677","2017_16_LAC_NYJ",2017-12-24,"NYJ","LAC",7,14,-7,"2017"
"4678","2017_16_LA_TEN",2017-12-24,"TEN","LA",23,27,-4,"2017"
"4679","2017_16_MIA_KC",2017-12-24,"KC","MIA",29,13,16,"2017"
"4680","2017_16_MIN_GB",2017-12-23,"GB","MIN",0,16,-16,"2017"
"4681","2017_16_NYG_ARI",2017-12-24,"ARI","NYG",23,0,23,"2017"
"4682","2017_16_OAK_PHI",2017-12-25,"PHI","LV",19,10,9,"2017"
"4683","2017_16_PIT_HOU",2017-12-25,"HOU","PIT",6,34,-28,"2017"
"4684","2017_16_SEA_DAL",2017-12-24,"DAL","SEA",12,21,-9,"2017"
"4685","2017_16_TB_CAR",2017-12-24,"CAR","TB",22,19,3,"2017"
"4686","2017_17_ARI_SEA",2017-12-31,"SEA","ARI",24,26,-2,"2017"
"4687","2017_17_BUF_MIA",2017-12-31,"MIA","BUF",16,22,-6,"2017"
"4688","2017_17_CAR_ATL",2017-12-31,"ATL","CAR",22,10,12,"2017"
"4689","2017_17_CHI_MIN",2017-12-31,"MIN","CHI",23,10,13,"2017"
"4690","2017_17_CIN_BAL",2017-12-31,"BAL","CIN",27,31,-4,"2017"
"4691","2017_17_CLE_PIT",2017-12-31,"PIT","CLE",28,24,4,"2017"
"4692","2017_17_DAL_PHI",2017-12-31,"PHI","DAL",0,6,-6,"2017"
"4693","2017_17_GB_DET",2017-12-31,"DET","GB",35,11,24,"2017"
"4694","2017_17_HOU_IND",2017-12-31,"IND","HOU",22,13,9,"2017"
"4695","2017_17_JAX_TEN",2017-12-31,"TEN","JAX",15,10,5,"2017"
"4696","2017_17_KC_DEN",2017-12-31,"DEN","KC",24,27,-3,"2017"
"4697","2017_17_NO_TB",2017-12-31,"TB","NO",31,24,7,"2017"
"4698","2017_17_NYJ_NE",2017-12-31,"NE","NYJ",26,6,20,"2017"
"4699","2017_17_OAK_LAC",2017-12-31,"LAC","LV",30,10,20,"2017"
"4700","2017_17_SF_LA",2017-12-31,"LA","SF",13,34,-21,"2017"
"4701","2017_17_WAS_NYG",2017-12-31,"NYG","WAS",18,10,8,"2017"
"4702","2018_01_ATL_PHI",2018-09-06,"PHI","ATL",18,12,6,"2018"
"4703","2018_01_BUF_BAL",2018-09-09,"BAL","BUF",47,3,44,"2018"
"4704","2018_01_CHI_GB",2018-09-09,"GB","CHI",24,23,1,"2018"
"4705","2018_01_CIN_IND",2018-09-09,"IND","CIN",23,34,-11,"2018"
"4706","2018_01_DAL_CAR",2018-09-09,"CAR","DAL",16,8,8,"2018"
"4707","2018_01_HOU_NE",2018-09-09,"NE","HOU",27,20,7,"2018"
"4708","2018_01_JAX_NYG",2018-09-09,"NYG","JAX",15,20,-5,"2018"
"4709","2018_01_KC_LAC",2018-09-09,"LAC","KC",28,38,-10,"2018"
"4710","2018_01_LA_OAK",2018-09-10,"LV","LA",13,33,-20,"2018"
"4711","2018_01_NYJ_DET",2018-09-10,"DET","NYJ",17,48,-31,"2018"
"4712","2018_01_PIT_CLE",2018-09-09,"CLE","PIT",21,21,0,"2018"
"4713","2018_01_SEA_DEN",2018-09-09,"DEN","SEA",27,24,3,"2018"
"4714","2018_01_SF_MIN",2018-09-09,"MIN","SF",24,16,8,"2018"
"4715","2018_01_TB_NO",2018-09-09,"NO","TB",40,48,-8,"2018"
"4716","2018_01_TEN_MIA",2018-09-09,"MIA","TEN",27,20,7,"2018"
"4717","2018_01_WAS_ARI",2018-09-09,"ARI","WAS",6,24,-18,"2018"
"4718","2018_02_ARI_LA",2018-09-16,"LA","ARI",34,0,34,"2018"
"4719","2018_02_BAL_CIN",2018-09-13,"CIN","BAL",34,23,11,"2018"
"4720","2018_02_CAR_ATL",2018-09-16,"ATL","CAR",31,24,7,"2018"
"4721","2018_02_CLE_NO",2018-09-16,"NO","CLE",21,18,3,"2018"
"4722","2018_02_DET_SF",2018-09-16,"SF","DET",30,27,3,"2018"
"4723","2018_02_HOU_TEN",2018-09-16,"TEN","HOU",20,17,3,"2018"
"4724","2018_02_IND_WAS",2018-09-16,"WAS","IND",9,21,-12,"2018"
"4725","2018_02_KC_PIT",2018-09-16,"PIT","KC",37,42,-5,"2018"
"4726","2018_02_LAC_BUF",2018-09-16,"BUF","LAC",20,31,-11,"2018"
"4727","2018_02_MIA_NYJ",2018-09-16,"NYJ","MIA",12,20,-8,"2018"
"4728","2018_02_MIN_GB",2018-09-16,"GB","MIN",29,29,0,"2018"
"4729","2018_02_NE_JAX",2018-09-16,"JAX","NE",31,20,11,"2018"
"4730","2018_02_NYG_DAL",2018-09-16,"DAL","NYG",20,13,7,"2018"
"4731","2018_02_OAK_DEN",2018-09-16,"DEN","LV",20,19,1,"2018"
"4732","2018_02_PHI_TB",2018-09-16,"TB","PHI",27,21,6,"2018"
"4733","2018_02_SEA_CHI",2018-09-17,"CHI","SEA",24,17,7,"2018"
"4734","2018_03_BUF_MIN",2018-09-23,"MIN","BUF",6,27,-21,"2018"
"4735","2018_03_CHI_ARI",2018-09-23,"ARI","CHI",14,16,-2,"2018"
"4736","2018_03_CIN_CAR",2018-09-23,"CAR","CIN",31,21,10,"2018"
"4737","2018_03_DAL_SEA",2018-09-23,"SEA","DAL",24,13,11,"2018"
"4738","2018_03_DEN_BAL",2018-09-23,"BAL","DEN",27,14,13,"2018"
"4739","2018_03_GB_WAS",2018-09-23,"WAS","GB",31,17,14,"2018"
"4740","2018_03_IND_PHI",2018-09-23,"PHI","IND",20,16,4,"2018"
"4741","2018_03_LAC_LA",2018-09-23,"LA","LAC",35,23,12,"2018"
"4742","2018_03_NE_DET",2018-09-23,"DET","NE",26,10,16,"2018"
"4743","2018_03_NO_ATL",2018-09-23,"ATL","NO",37,43,-6,"2018"
"4744","2018_03_NYG_HOU",2018-09-23,"HOU","NYG",22,27,-5,"2018"
"4745","2018_03_NYJ_CLE",2018-09-20,"CLE","NYJ",21,17,4,"2018"
"4746","2018_03_OAK_MIA",2018-09-23,"MIA","LV",28,20,8,"2018"
"4747","2018_03_PIT_TB",2018-09-24,"TB","PIT",27,30,-3,"2018"
"4748","2018_03_SF_KC",2018-09-23,"KC","SF",38,27,11,"2018"
"4749","2018_03_TEN_JAX",2018-09-23,"JAX","TEN",6,9,-3,"2018"
"4750","2018_04_BAL_PIT",2018-09-30,"PIT","BAL",14,26,-12,"2018"
"4751","2018_04_BUF_GB",2018-09-30,"GB","BUF",22,0,22,"2018"
"4752","2018_04_CIN_ATL",2018-09-30,"ATL","CIN",36,37,-1,"2018"
"4753","2018_04_CLE_OAK",2018-09-30,"LV","CLE",45,42,3,"2018"
"4754","2018_04_DET_DAL",2018-09-30,"DAL","DET",26,24,2,"2018"
"4755","2018_04_HOU_IND",2018-09-30,"IND","HOU",34,37,-3,"2018"
"4756","2018_04_KC_DEN",2018-10-01,"DEN","KC",23,27,-4,"2018"
"4757","2018_04_MIA_NE",2018-09-30,"NE","MIA",38,7,31,"2018"
"4758","2018_04_MIN_LA",2018-09-27,"LA","MIN",38,31,7,"2018"
"4759","2018_04_NO_NYG",2018-09-30,"NYG","NO",18,33,-15,"2018"
"4760","2018_04_NYJ_JAX",2018-09-30,"JAX","NYJ",31,12,19,"2018"
"4761","2018_04_PHI_TEN",2018-09-30,"TEN","PHI",26,23,3,"2018"
"4762","2018_04_SEA_ARI",2018-09-30,"ARI","SEA",17,20,-3,"2018"
"4763","2018_04_SF_LAC",2018-09-30,"LAC","SF",29,27,2,"2018"
"4764","2018_04_TB_CHI",2018-09-30,"CHI","TB",48,10,38,"2018"
"4765","2018_05_ARI_SF",2018-10-07,"SF","ARI",18,28,-10,"2018"
"4766","2018_05_ATL_PIT",2018-10-07,"PIT","ATL",41,17,24,"2018"
"4767","2018_05_BAL_CLE",2018-10-07,"CLE","BAL",12,9,3,"2018"
"4768","2018_05_DAL_HOU",2018-10-07,"HOU","DAL",19,16,3,"2018"
"4769","2018_05_DEN_NYJ",2018-10-07,"NYJ","DEN",34,16,18,"2018"
"4770","2018_05_GB_DET",2018-10-07,"DET","GB",31,23,8,"2018"
"4771","2018_05_IND_NE",2018-10-04,"NE","IND",38,24,14,"2018"
"4772","2018_05_JAX_KC",2018-10-07,"KC","JAX",30,14,16,"2018"
"4773","2018_05_LA_SEA",2018-10-07,"SEA","LA",31,33,-2,"2018"
"4774","2018_05_MIA_CIN",2018-10-07,"CIN","MIA",27,17,10,"2018"
"4775","2018_05_MIN_PHI",2018-10-07,"PHI","MIN",21,23,-2,"2018"
"4776","2018_05_NYG_CAR",2018-10-07,"CAR","NYG",33,31,2,"2018"
"4777","2018_05_OAK_LAC",2018-10-07,"LAC","LV",26,10,16,"2018"
"4778","2018_05_TEN_BUF",2018-10-07,"BUF","TEN",13,12,1,"2018"
"4779","2018_05_WAS_NO",2018-10-08,"NO","WAS",43,19,24,"2018"
"4780","2018_06_ARI_MIN",2018-10-14,"MIN","ARI",27,17,10,"2018"
"4781","2018_06_BAL_TEN",2018-10-14,"TEN","BAL",0,21,-21,"2018"
"4782","2018_06_BUF_HOU",2018-10-14,"HOU","BUF",20,13,7,"2018"
"4783","2018_06_CAR_WAS",2018-10-14,"WAS","CAR",23,17,6,"2018"
"4784","2018_06_CHI_MIA",2018-10-14,"MIA","CHI",31,28,3,"2018"
"4785","2018_06_IND_NYJ",2018-10-14,"NYJ","IND",42,34,8,"2018"
"4786","2018_06_JAX_DAL",2018-10-14,"DAL","JAX",40,7,33,"2018"
"4787","2018_06_KC_NE",2018-10-14,"NE","KC",43,40,3,"2018"
"4788","2018_06_LAC_CLE",2018-10-14,"CLE","LAC",14,38,-24,"2018"
"4789","2018_06_LA_DEN",2018-10-14,"DEN","LA",20,23,-3,"2018"
"4790","2018_06_PHI_NYG",2018-10-11,"NYG","PHI",13,34,-21,"2018"
"4791","2018_06_PIT_CIN",2018-10-14,"CIN","PIT",21,28,-7,"2018"
"4792","2018_06_SEA_OAK",2018-10-14,"LV","SEA",3,27,-24,"2018"
"4793","2018_06_SF_GB",2018-10-15,"GB","SF",33,30,3,"2018"
"4794","2018_06_TB_ATL",2018-10-14,"ATL","TB",34,29,5,"2018"
"4795","2018_07_BUF_IND",2018-10-21,"IND","BUF",37,5,32,"2018"
"4796","2018_07_CAR_PHI",2018-10-21,"PHI","CAR",17,21,-4,"2018"
"4797","2018_07_CIN_KC",2018-10-21,"KC","CIN",45,10,35,"2018"
"4798","2018_07_CLE_TB",2018-10-21,"TB","CLE",26,23,3,"2018"
"4799","2018_07_DAL_WAS",2018-10-21,"WAS","DAL",20,17,3,"2018"
"4800","2018_07_DEN_ARI",2018-10-18,"ARI","DEN",10,45,-35,"2018"
"4801","2018_07_DET_MIA",2018-10-21,"MIA","DET",21,32,-11,"2018"
"4802","2018_07_HOU_JAX",2018-10-21,"JAX","HOU",7,20,-13,"2018"
"4803","2018_07_LA_SF",2018-10-21,"SF","LA",10,39,-29,"2018"
"4804","2018_07_MIN_NYJ",2018-10-21,"NYJ","MIN",17,37,-20,"2018"
"4805","2018_07_NE_CHI",2018-10-21,"CHI","NE",31,38,-7,"2018"
"4806","2018_07_NO_BAL",2018-10-21,"BAL","NO",23,24,-1,"2018"
"4807","2018_07_NYG_ATL",2018-10-22,"ATL","NYG",23,20,3,"2018"
"4808","2018_07_TEN_LAC",2018-10-21,"LAC","TEN",20,19,1,"2018"
"4809","2018_08_BAL_CAR",2018-10-28,"CAR","BAL",36,21,15,"2018"
"4810","2018_08_CLE_PIT",2018-10-28,"PIT","CLE",33,18,15,"2018"
"4811","2018_08_DEN_KC",2018-10-28,"KC","DEN",30,23,7,"2018"
"4812","2018_08_GB_LA",2018-10-28,"LA","GB",29,27,2,"2018"
"4813","2018_08_IND_OAK",2018-10-28,"LV","IND",28,42,-14,"2018"
"4814","2018_08_MIA_HOU",2018-10-25,"HOU","MIA",42,23,19,"2018"
"4815","2018_08_NE_BUF",2018-10-29,"BUF","NE",6,25,-19,"2018"
"4816","2018_08_NO_MIN",2018-10-28,"MIN","NO",20,30,-10,"2018"
"4817","2018_08_NYJ_CHI",2018-10-28,"CHI","NYJ",24,10,14,"2018"
"4818","2018_08_PHI_JAX",2018-10-28,"JAX","PHI",18,24,-6,"2018"
"4819","2018_08_SEA_DET",2018-10-28,"DET","SEA",14,28,-14,"2018"
"4820","2018_08_SF_ARI",2018-10-28,"ARI","SF",18,15,3,"2018"
"4821","2018_08_TB_CIN",2018-10-28,"CIN","TB",37,34,3,"2018"
"4822","2018_08_WAS_NYG",2018-10-28,"NYG","WAS",13,20,-7,"2018"
"4823","2018_09_ATL_WAS",2018-11-04,"WAS","ATL",14,38,-24,"2018"
"4824","2018_09_CHI_BUF",2018-11-04,"BUF","CHI",9,41,-32,"2018"
"4825","2018_09_DET_MIN",2018-11-04,"MIN","DET",24,9,15,"2018"
"4826","2018_09_GB_NE",2018-11-04,"NE","GB",31,17,14,"2018"
"4827","2018_09_HOU_DEN",2018-11-04,"DEN","HOU",17,19,-2,"2018"
"4828","2018_09_KC_CLE",2018-11-04,"CLE","KC",21,37,-16,"2018"
"4829","2018_09_LAC_SEA",2018-11-04,"SEA","LAC",17,25,-8,"2018"
"4830","2018_09_LA_NO",2018-11-04,"NO","LA",45,35,10,"2018"
"4831","2018_09_NYJ_MIA",2018-11-04,"MIA","NYJ",13,6,7,"2018"
"4832","2018_09_OAK_SF",2018-11-01,"SF","LV",34,3,31,"2018"
"4833","2018_09_PIT_BAL",2018-11-04,"BAL","PIT",16,23,-7,"2018"
"4834","2018_09_TB_CAR",2018-11-04,"CAR","TB",42,28,14,"2018"
"4835","2018_09_TEN_DAL",2018-11-05,"DAL","TEN",14,28,-14,"2018"
"4836","2018_10_ARI_KC",2018-11-11,"KC","ARI",26,14,12,"2018"
"4837","2018_10_ATL_CLE",2018-11-11,"CLE","ATL",28,16,12,"2018"
"4838","2018_10_BUF_NYJ",2018-11-11,"NYJ","BUF",10,41,-31,"2018"
"4839","2018_10_CAR_PIT",2018-11-08,"PIT","CAR",52,21,31,"2018"
"4840","2018_10_DAL_PHI",2018-11-11,"PHI","DAL",20,27,-7,"2018"
"4841","2018_10_DET_CHI",2018-11-11,"CHI","DET",34,22,12,"2018"
"4842","2018_10_JAX_IND",2018-11-11,"IND","JAX",29,26,3,"2018"
"4843","2018_10_LAC_OAK",2018-11-11,"LV","LAC",6,20,-14,"2018"
"4844","2018_10_MIA_GB",2018-11-11,"GB","MIA",31,12,19,"2018"
"4845","2018_10_NE_TEN",2018-11-11,"TEN","NE",34,10,24,"2018"
"4846","2018_10_NO_CIN",2018-11-11,"CIN","NO",14,51,-37,"2018"
"4847","2018_10_NYG_SF",2018-11-12,"SF","NYG",23,27,-4,"2018"
"4848","2018_10_SEA_LA",2018-11-11,"LA","SEA",36,31,5,"2018"
"4849","2018_10_WAS_TB",2018-11-11,"TB","WAS",3,16,-13,"2018"
"4850","2018_11_CAR_DET",2018-11-18,"DET","CAR",20,19,1,"2018"
"4851","2018_11_CIN_BAL",2018-11-18,"BAL","CIN",24,21,3,"2018"
"4852","2018_11_DAL_ATL",2018-11-18,"ATL","DAL",19,22,-3,"2018"
"4853","2018_11_DEN_LAC",2018-11-18,"LAC","DEN",22,23,-1,"2018"
"4854","2018_11_GB_SEA",2018-11-15,"SEA","GB",27,24,3,"2018"
"4855","2018_11_HOU_WAS",2018-11-18,"WAS","HOU",21,23,-2,"2018"
"4856","2018_11_KC_LA",2018-11-19,"LA","KC",54,51,3,"2018"
"4857","2018_11_MIN_CHI",2018-11-18,"CHI","MIN",25,20,5,"2018"
"4858","2018_11_OAK_ARI",2018-11-18,"ARI","LV",21,23,-2,"2018"
"4859","2018_11_PHI_NO",2018-11-18,"NO","PHI",48,7,41,"2018"
"4860","2018_11_PIT_JAX",2018-11-18,"JAX","PIT",16,20,-4,"2018"
"4861","2018_11_TB_NYG",2018-11-18,"NYG","TB",38,35,3,"2018"
"4862","2018_11_TEN_IND",2018-11-18,"IND","TEN",38,10,28,"2018"
"4863","2018_12_ARI_LAC",2018-11-25,"LAC","ARI",45,10,35,"2018"
"4864","2018_12_ATL_NO",2018-11-22,"NO","ATL",31,17,14,"2018"
"4865","2018_12_CHI_DET",2018-11-22,"DET","CHI",16,23,-7,"2018"
"4866","2018_12_CLE_CIN",2018-11-25,"CIN","CLE",20,35,-15,"2018"
"4867","2018_12_GB_MIN",2018-11-25,"MIN","GB",24,17,7,"2018"
"4868","2018_12_JAX_BUF",2018-11-25,"BUF","JAX",24,21,3,"2018"
"4869","2018_12_MIA_IND",2018-11-25,"IND","MIA",27,24,3,"2018"
"4870","2018_12_NE_NYJ",2018-11-25,"NYJ","NE",13,27,-14,"2018"
"4871","2018_12_NYG_PHI",2018-11-25,"PHI","NYG",25,22,3,"2018"
"4872","2018_12_OAK_BAL",2018-11-25,"BAL","LV",34,17,17,"2018"
"4873","2018_12_PIT_DEN",2018-11-25,"DEN","PIT",24,17,7,"2018"
"4874","2018_12_SEA_CAR",2018-11-25,"CAR","SEA",27,30,-3,"2018"
"4875","2018_12_SF_TB",2018-11-25,"TB","SF",27,9,18,"2018"
"4876","2018_12_TEN_HOU",2018-11-26,"HOU","TEN",34,17,17,"2018"
"4877","2018_12_WAS_DAL",2018-11-22,"DAL","WAS",31,23,8,"2018"
"4878","2018_13_ARI_GB",2018-12-02,"GB","ARI",17,20,-3,"2018"
"4879","2018_13_BAL_ATL",2018-12-02,"ATL","BAL",16,26,-10,"2018"
"4880","2018_13_BUF_MIA",2018-12-02,"MIA","BUF",21,17,4,"2018"
"4881","2018_13_CAR_TB",2018-12-02,"TB","CAR",24,17,7,"2018"
"4882","2018_13_CHI_NYG",2018-12-02,"NYG","CHI",30,27,3,"2018"
"4883","2018_13_CLE_HOU",2018-12-02,"HOU","CLE",29,13,16,"2018"
"4884","2018_13_DEN_CIN",2018-12-02,"CIN","DEN",10,24,-14,"2018"
"4885","2018_13_IND_JAX",2018-12-02,"JAX","IND",6,0,6,"2018"
"4886","2018_13_KC_OAK",2018-12-02,"LV","KC",33,40,-7,"2018"
"4887","2018_13_LAC_PIT",2018-12-02,"PIT","LAC",30,33,-3,"2018"
"4888","2018_13_LA_DET",2018-12-02,"DET","LA",16,30,-14,"2018"
"4889","2018_13_MIN_NE",2018-12-02,"NE","MIN",24,10,14,"2018"
"4890","2018_13_NO_DAL",2018-11-29,"DAL","NO",13,10,3,"2018"
"4891","2018_13_NYJ_TEN",2018-12-02,"TEN","NYJ",26,22,4,"2018"
"4892","2018_13_SF_SEA",2018-12-02,"SEA","SF",43,16,27,"2018"
"4893","2018_13_WAS_PHI",2018-12-03,"PHI","WAS",28,13,15,"2018"
"4894","2018_14_ATL_GB",2018-12-09,"GB","ATL",34,20,14,"2018"
"4895","2018_14_BAL_KC",2018-12-09,"KC","BAL",27,24,3,"2018"
"4896","2018_14_CAR_CLE",2018-12-09,"CLE","CAR",26,20,6,"2018"
"4897","2018_14_CIN_LAC",2018-12-09,"LAC","CIN",26,21,5,"2018"
"4898","2018_14_DEN_SF",2018-12-09,"SF","DEN",20,14,6,"2018"
"4899","2018_14_DET_ARI",2018-12-09,"ARI","DET",3,17,-14,"2018"
"4900","2018_14_IND_HOU",2018-12-09,"HOU","IND",21,24,-3,"2018"
"4901","2018_14_JAX_TEN",2018-12-06,"TEN","JAX",30,9,21,"2018"
"4902","2018_14_LA_CHI",2018-12-09,"CHI","LA",15,6,9,"2018"
"4903","2018_14_MIN_SEA",2018-12-10,"SEA","MIN",21,7,14,"2018"
"4904","2018_14_NE_MIA",2018-12-09,"MIA","NE",34,33,1,"2018"
"4905","2018_14_NO_TB",2018-12-09,"TB","NO",14,28,-14,"2018"
"4906","2018_14_NYG_WAS",2018-12-09,"WAS","NYG",16,40,-24,"2018"
"4907","2018_14_NYJ_BUF",2018-12-09,"BUF","NYJ",23,27,-4,"2018"
"4908","2018_14_PHI_DAL",2018-12-09,"DAL","PHI",29,23,6,"2018"
"4909","2018_14_PIT_OAK",2018-12-09,"LV","PIT",24,21,3,"2018"
"4910","2018_15_ARI_ATL",2018-12-16,"ATL","ARI",40,14,26,"2018"
"4911","2018_15_CLE_DEN",2018-12-15,"DEN","CLE",16,17,-1,"2018"
"4912","2018_15_DAL_IND",2018-12-16,"IND","DAL",23,0,23,"2018"
"4913","2018_15_DET_BUF",2018-12-16,"BUF","DET",14,13,1,"2018"
"4914","2018_15_GB_CHI",2018-12-16,"CHI","GB",24,17,7,"2018"
"4915","2018_15_HOU_NYJ",2018-12-15,"NYJ","HOU",22,29,-7,"2018"
"4916","2018_15_LAC_KC",2018-12-13,"KC","LAC",28,29,-1,"2018"
"4917","2018_15_MIA_MIN",2018-12-16,"MIN","MIA",41,17,24,"2018"
"4918","2018_15_NE_PIT",2018-12-16,"PIT","NE",17,10,7,"2018"
"4919","2018_15_NO_CAR",2018-12-17,"CAR","NO",9,12,-3,"2018"
"4920","2018_15_OAK_CIN",2018-12-16,"CIN","LV",30,16,14,"2018"
"4921","2018_15_PHI_LA",2018-12-16,"LA","PHI",23,30,-7,"2018"
"4922","2018_15_SEA_SF",2018-12-16,"SF","SEA",26,23,3,"2018"
"4923","2018_15_TB_BAL",2018-12-16,"BAL","TB",20,12,8,"2018"
"4924","2018_15_TEN_NYG",2018-12-16,"NYG","TEN",0,17,-17,"2018"
"4925","2018_15_WAS_JAX",2018-12-16,"JAX","WAS",13,16,-3,"2018"
"4926","2018_16_ATL_CAR",2018-12-23,"CAR","ATL",10,24,-14,"2018"
"4927","2018_16_BAL_LAC",2018-12-22,"LAC","BAL",10,22,-12,"2018"
"4928","2018_16_BUF_NE",2018-12-23,"NE","BUF",24,12,12,"2018"
"4929","2018_16_CHI_SF",2018-12-23,"SF","CHI",9,14,-5,"2018"
"4930","2018_16_CIN_CLE",2018-12-23,"CLE","CIN",26,18,8,"2018"
"4931","2018_16_DEN_OAK",2018-12-24,"LV","DEN",27,14,13,"2018"
"4932","2018_16_GB_NYJ",2018-12-23,"NYJ","GB",38,44,-6,"2018"
"4933","2018_16_HOU_PHI",2018-12-23,"PHI","HOU",32,30,2,"2018"
"4934","2018_16_JAX_MIA",2018-12-23,"MIA","JAX",7,17,-10,"2018"
"4935","2018_16_KC_SEA",2018-12-23,"SEA","KC",38,31,7,"2018"
"4936","2018_16_LA_ARI",2018-12-23,"ARI","LA",9,31,-22,"2018"
"4937","2018_16_MIN_DET",2018-12-23,"DET","MIN",9,27,-18,"2018"
"4938","2018_16_NYG_IND",2018-12-23,"IND","NYG",28,27,1,"2018"
"4939","2018_16_PIT_NO",2018-12-23,"NO","PIT",31,28,3,"2018"
"4940","2018_16_TB_DAL",2018-12-23,"DAL","TB",27,20,7,"2018"
"4941","2018_16_WAS_TEN",2018-12-22,"TEN","WAS",25,16,9,"2018"
"4942","2018_17_ARI_SEA",2018-12-30,"SEA","ARI",27,24,3,"2018"
"4943","2018_17_ATL_TB",2018-12-30,"TB","ATL",32,34,-2,"2018"
"4944","2018_17_CAR_NO",2018-12-30,"NO","CAR",14,33,-19,"2018"
"4945","2018_17_CHI_MIN",2018-12-30,"MIN","CHI",10,24,-14,"2018"
"4946","2018_17_CIN_PIT",2018-12-30,"PIT","CIN",16,13,3,"2018"
"4947","2018_17_CLE_BAL",2018-12-30,"BAL","CLE",26,24,2,"2018"
"4948","2018_17_DAL_NYG",2018-12-30,"NYG","DAL",35,36,-1,"2018"
"4949","2018_17_DET_GB",2018-12-30,"GB","DET",0,31,-31,"2018"
"4950","2018_17_IND_TEN",2018-12-30,"TEN","IND",17,33,-16,"2018"
"4951","2018_17_JAX_HOU",2018-12-30,"HOU","JAX",20,3,17,"2018"
"4952","2018_17_LAC_DEN",2018-12-30,"DEN","LAC",9,23,-14,"2018"
"4953","2018_17_MIA_BUF",2018-12-30,"BUF","MIA",42,17,25,"2018"
"4954","2018_17_NYJ_NE",2018-12-30,"NE","NYJ",38,3,35,"2018"
"4955","2018_17_OAK_KC",2018-12-30,"KC","LV",35,3,32,"2018"
"4956","2018_17_PHI_WAS",2018-12-30,"WAS","PHI",0,24,-24,"2018"
"4957","2018_17_SF_LA",2018-12-30,"LA","SF",48,32,16,"2018"
"4958","2019_01_ATL_MIN",2019-09-08,"MIN","ATL",28,12,16,"2019"
"4959","2019_01_BAL_MIA",2019-09-08,"MIA","BAL",10,59,-49,"2019"
"4960","2019_01_BUF_NYJ",2019-09-08,"NYJ","BUF",16,17,-1,"2019"
"4961","2019_01_CIN_SEA",2019-09-08,"SEA","CIN",21,20,1,"2019"
"4962","2019_01_DEN_OAK",2019-09-09,"LV","DEN",24,16,8,"2019"
"4963","2019_01_DET_ARI",2019-09-08,"ARI","DET",27,27,0,"2019"
"4964","2019_01_GB_CHI",2019-09-05,"CHI","GB",3,10,-7,"2019"
"4965","2019_01_HOU_NO",2019-09-09,"NO","HOU",30,28,2,"2019"
"4966","2019_01_IND_LAC",2019-09-08,"LAC","IND",30,24,6,"2019"
"4967","2019_01_KC_JAX",2019-09-08,"JAX","KC",26,40,-14,"2019"
"4968","2019_01_LA_CAR",2019-09-08,"CAR","LA",27,30,-3,"2019"
"4969","2019_01_NYG_DAL",2019-09-08,"DAL","NYG",35,17,18,"2019"
"4970","2019_01_PIT_NE",2019-09-08,"NE","PIT",33,3,30,"2019"
"4971","2019_01_SF_TB",2019-09-08,"TB","SF",17,31,-14,"2019"
"4972","2019_01_TEN_CLE",2019-09-08,"CLE","TEN",13,43,-30,"2019"
"4973","2019_01_WAS_PHI",2019-09-08,"PHI","WAS",32,27,5,"2019"
"4974","2019_02_ARI_BAL",2019-09-15,"BAL","ARI",23,17,6,"2019"
"4975","2019_02_BUF_NYG",2019-09-15,"NYG","BUF",14,28,-14,"2019"
"4976","2019_02_CHI_DEN",2019-09-15,"DEN","CHI",14,16,-2,"2019"
"4977","2019_02_CLE_NYJ",2019-09-16,"NYJ","CLE",3,23,-20,"2019"
"4978","2019_02_DAL_WAS",2019-09-15,"WAS","DAL",21,31,-10,"2019"
"4979","2019_02_IND_TEN",2019-09-15,"TEN","IND",17,19,-2,"2019"
"4980","2019_02_JAX_HOU",2019-09-15,"HOU","JAX",13,12,1,"2019"
"4981","2019_02_KC_OAK",2019-09-15,"LV","KC",10,28,-18,"2019"
"4982","2019_02_LAC_DET",2019-09-15,"DET","LAC",13,10,3,"2019"
"4983","2019_02_MIN_GB",2019-09-15,"GB","MIN",21,16,5,"2019"
"4984","2019_02_NE_MIA",2019-09-15,"MIA","NE",0,43,-43,"2019"
"4985","2019_02_NO_LA",2019-09-15,"LA","NO",27,9,18,"2019"
"4986","2019_02_PHI_ATL",2019-09-15,"ATL","PHI",24,20,4,"2019"
"4987","2019_02_SEA_PIT",2019-09-15,"PIT","SEA",26,28,-2,"2019"
"4988","2019_02_SF_CIN",2019-09-15,"CIN","SF",17,41,-24,"2019"
"4989","2019_02_TB_CAR",2019-09-12,"CAR","TB",14,20,-6,"2019"
"4990","2019_03_ATL_IND",2019-09-22,"IND","ATL",27,24,3,"2019"
"4991","2019_03_BAL_KC",2019-09-22,"KC","BAL",33,28,5,"2019"
"4992","2019_03_CAR_ARI",2019-09-22,"ARI","CAR",20,38,-18,"2019"
"4993","2019_03_CHI_WAS",2019-09-23,"WAS","CHI",15,31,-16,"2019"
"4994","2019_03_CIN_BUF",2019-09-22,"BUF","CIN",21,17,4,"2019"
"4995","2019_03_DEN_GB",2019-09-22,"GB","DEN",27,16,11,"2019"
"4996","2019_03_DET_PHI",2019-09-22,"PHI","DET",24,27,-3,"2019"
"4997","2019_03_HOU_LAC",2019-09-22,"LAC","HOU",20,27,-7,"2019"
"4998","2019_03_LA_CLE",2019-09-22,"CLE","LA",13,20,-7,"2019"
"4999","2019_03_MIA_DAL",2019-09-22,"DAL","MIA",31,6,25,"2019"
"5000","2019_03_NO_SEA",2019-09-22,"SEA","NO",27,33,-6,"2019"
"5001","2019_03_NYG_TB",2019-09-22,"TB","NYG",31,32,-1,"2019"
"5002","2019_03_NYJ_NE",2019-09-22,"NE","NYJ",30,14,16,"2019"
"5003","2019_03_OAK_MIN",2019-09-22,"MIN","LV",34,14,20,"2019"
"5004","2019_03_PIT_SF",2019-09-22,"SF","PIT",24,20,4,"2019"
"5005","2019_03_TEN_JAX",2019-09-19,"JAX","TEN",20,7,13,"2019"
"5006","2019_04_CAR_HOU",2019-09-29,"HOU","CAR",10,16,-6,"2019"
"5007","2019_04_CIN_PIT",2019-09-30,"PIT","CIN",27,3,24,"2019"
"5008","2019_04_CLE_BAL",2019-09-29,"BAL","CLE",25,40,-15,"2019"
"5009","2019_04_DAL_NO",2019-09-29,"NO","DAL",12,10,2,"2019"
"5010","2019_04_JAX_DEN",2019-09-29,"DEN","JAX",24,26,-2,"2019"
"5011","2019_04_KC_DET",2019-09-29,"DET","KC",30,34,-4,"2019"
"5012","2019_04_LAC_MIA",2019-09-29,"MIA","LAC",10,30,-20,"2019"
"5013","2019_04_MIN_CHI",2019-09-29,"CHI","MIN",16,6,10,"2019"
"5014","2019_04_NE_BUF",2019-09-29,"BUF","NE",10,16,-6,"2019"
"5015","2019_04_OAK_IND",2019-09-29,"IND","LV",24,31,-7,"2019"
"5016","2019_04_PHI_GB",2019-09-26,"GB","PHI",27,34,-7,"2019"
"5017","2019_04_SEA_ARI",2019-09-29,"ARI","SEA",10,27,-17,"2019"
"5018","2019_04_TB_LA",2019-09-29,"LA","TB",40,55,-15,"2019"
"5019","2019_04_TEN_ATL",2019-09-29,"ATL","TEN",10,24,-14,"2019"
"5020","2019_04_WAS_NYG",2019-09-29,"NYG","WAS",24,3,21,"2019"
"5021","2019_05_ARI_CIN",2019-10-06,"CIN","ARI",23,26,-3,"2019"
"5022","2019_05_ATL_HOU",2019-10-06,"HOU","ATL",53,32,21,"2019"
"5023","2019_05_BAL_PIT",2019-10-06,"PIT","BAL",23,26,-3,"2019"
"5024","2019_05_BUF_TEN",2019-10-06,"TEN","BUF",7,14,-7,"2019"
"5025","2019_05_CHI_OAK",2019-10-06,"LV","CHI",24,21,3,"2019"
"5026","2019_05_CLE_SF",2019-10-07,"SF","CLE",31,3,28,"2019"
"5027","2019_05_DEN_LAC",2019-10-06,"LAC","DEN",13,20,-7,"2019"
"5028","2019_05_GB_DAL",2019-10-06,"DAL","GB",24,34,-10,"2019"
"5029","2019_05_IND_KC",2019-10-06,"KC","IND",13,19,-6,"2019"
"5030","2019_05_JAX_CAR",2019-10-06,"CAR","JAX",34,27,7,"2019"
"5031","2019_05_LA_SEA",2019-10-03,"SEA","LA",30,29,1,"2019"
"5032","2019_05_MIN_NYG",2019-10-06,"NYG","MIN",10,28,-18,"2019"
"5033","2019_05_NE_WAS",2019-10-06,"WAS","NE",7,33,-26,"2019"
"5034","2019_05_NYJ_PHI",2019-10-06,"PHI","NYJ",31,6,25,"2019"
"5035","2019_05_TB_NO",2019-10-06,"NO","TB",31,24,7,"2019"
"5036","2019_06_ATL_ARI",2019-10-13,"ARI","ATL",34,33,1,"2019"
"5037","2019_06_CAR_TB",2019-10-13,"TB","CAR",26,37,-11,"2019"
"5038","2019_06_CIN_BAL",2019-10-13,"BAL","CIN",23,17,6,"2019"
"5039","2019_06_DAL_NYJ",2019-10-13,"NYJ","DAL",24,22,2,"2019"
"5040","2019_06_DET_GB",2019-10-14,"GB","DET",23,22,1,"2019"
"5041","2019_06_HOU_KC",2019-10-13,"KC","HOU",24,31,-7,"2019"
"5042","2019_06_NO_JAX",2019-10-13,"JAX","NO",6,13,-7,"2019"
"5043","2019_06_NYG_NE",2019-10-10,"NE","NYG",35,14,21,"2019"
"5044","2019_06_PHI_MIN",2019-10-13,"MIN","PHI",38,20,18,"2019"
"5045","2019_06_PIT_LAC",2019-10-13,"LAC","PIT",17,24,-7,"2019"
"5046","2019_06_SEA_CLE",2019-10-13,"CLE","SEA",28,32,-4,"2019"
"5047","2019_06_SF_LA",2019-10-13,"LA","SF",7,20,-13,"2019"
"5048","2019_06_TEN_DEN",2019-10-13,"DEN","TEN",16,0,16,"2019"
"5049","2019_06_WAS_MIA",2019-10-13,"MIA","WAS",16,17,-1,"2019"
"5050","2019_07_ARI_NYG",2019-10-20,"NYG","ARI",21,27,-6,"2019"
"5051","2019_07_BAL_SEA",2019-10-20,"SEA","BAL",16,30,-14,"2019"
"5052","2019_07_HOU_IND",2019-10-20,"IND","HOU",30,23,7,"2019"
"5053","2019_07_JAX_CIN",2019-10-20,"CIN","JAX",17,27,-10,"2019"
"5054","2019_07_KC_DEN",2019-10-17,"DEN","KC",6,30,-24,"2019"
"5055","2019_07_LAC_TEN",2019-10-20,"TEN","LAC",23,20,3,"2019"
"5056","2019_07_LA_ATL",2019-10-20,"ATL","LA",10,37,-27,"2019"
"5057","2019_07_MIA_BUF",2019-10-20,"BUF","MIA",31,21,10,"2019"
"5058","2019_07_MIN_DET",2019-10-20,"DET","MIN",30,42,-12,"2019"
"5059","2019_07_NE_NYJ",2019-10-21,"NYJ","NE",0,33,-33,"2019"
"5060","2019_07_NO_CHI",2019-10-20,"CHI","NO",25,36,-11,"2019"
"5061","2019_07_OAK_GB",2019-10-20,"GB","LV",42,24,18,"2019"
"5062","2019_07_PHI_DAL",2019-10-20,"DAL","PHI",37,10,27,"2019"
"5063","2019_07_SF_WAS",2019-10-20,"WAS","SF",0,9,-9,"2019"
"5064","2019_08_ARI_NO",2019-10-27,"NO","ARI",31,9,22,"2019"
"5065","2019_08_CAR_SF",2019-10-27,"SF","CAR",51,13,38,"2019"
"5066","2019_08_CIN_LA",2019-10-27,"LA","CIN",24,10,14,"2019"
"5067","2019_08_CLE_NE",2019-10-27,"NE","CLE",27,13,14,"2019"
"5068","2019_08_DEN_IND",2019-10-27,"IND","DEN",15,13,2,"2019"
"5069","2019_08_GB_KC",2019-10-27,"KC","GB",24,31,-7,"2019"
"5070","2019_08_LAC_CHI",2019-10-27,"CHI","LAC",16,17,-1,"2019"
"5071","2019_08_MIA_PIT",2019-10-28,"PIT","MIA",27,14,13,"2019"
"5072","2019_08_NYG_DET",2019-10-27,"DET","NYG",31,26,5,"2019"
"5073","2019_08_NYJ_JAX",2019-10-27,"JAX","NYJ",29,15,14,"2019"
"5074","2019_08_OAK_HOU",2019-10-27,"HOU","LV",27,24,3,"2019"
"5075","2019_08_PHI_BUF",2019-10-27,"BUF","PHI",13,31,-18,"2019"
"5076","2019_08_SEA_ATL",2019-10-27,"ATL","SEA",20,27,-7,"2019"
"5077","2019_08_TB_TEN",2019-10-27,"TEN","TB",27,23,4,"2019"
"5078","2019_08_WAS_MIN",2019-10-24,"MIN","WAS",19,9,10,"2019"
"5079","2019_09_CHI_PHI",2019-11-03,"PHI","CHI",22,14,8,"2019"
"5080","2019_09_CLE_DEN",2019-11-03,"DEN","CLE",24,19,5,"2019"
"5081","2019_09_DAL_NYG",2019-11-04,"NYG","DAL",18,37,-19,"2019"
"5082","2019_09_DET_OAK",2019-11-03,"LV","DET",31,24,7,"2019"
"5083","2019_09_GB_LAC",2019-11-03,"LAC","GB",26,11,15,"2019"
"5084","2019_09_HOU_JAX",2019-11-03,"JAX","HOU",3,26,-23,"2019"
"5085","2019_09_IND_PIT",2019-11-03,"PIT","IND",26,24,2,"2019"
"5086","2019_09_MIN_KC",2019-11-03,"KC","MIN",26,23,3,"2019"
"5087","2019_09_NE_BAL",2019-11-03,"BAL","NE",37,20,17,"2019"
"5088","2019_09_NYJ_MIA",2019-11-03,"MIA","NYJ",26,18,8,"2019"
"5089","2019_09_SF_ARI",2019-10-31,"ARI","SF",25,28,-3,"2019"
"5090","2019_09_TB_SEA",2019-11-03,"SEA","TB",40,34,6,"2019"
"5091","2019_09_TEN_CAR",2019-11-03,"CAR","TEN",30,20,10,"2019"
"5092","2019_09_WAS_BUF",2019-11-03,"BUF","WAS",24,9,15,"2019"
"5093","2019_10_ARI_TB",2019-11-10,"TB","ARI",30,27,3,"2019"
"5094","2019_10_ATL_NO",2019-11-10,"NO","ATL",9,26,-17,"2019"
"5095","2019_10_BAL_CIN",2019-11-10,"CIN","BAL",13,49,-36,"2019"
"5096","2019_10_BUF_CLE",2019-11-10,"CLE","BUF",19,16,3,"2019"
"5097","2019_10_CAR_GB",2019-11-10,"GB","CAR",24,16,8,"2019"
"5098","2019_10_DET_CHI",2019-11-10,"CHI","DET",20,13,7,"2019"
"5099","2019_10_KC_TEN",2019-11-10,"TEN","KC",35,32,3,"2019"
"5100","2019_10_LAC_OAK",2019-11-07,"LV","LAC",26,24,2,"2019"
"5101","2019_10_LA_PIT",2019-11-10,"PIT","LA",17,12,5,"2019"
"5102","2019_10_MIA_IND",2019-11-10,"IND","MIA",12,16,-4,"2019"
"5103","2019_10_MIN_DAL",2019-11-10,"DAL","MIN",24,28,-4,"2019"
"5104","2019_10_NYG_NYJ",2019-11-10,"NYJ","NYG",34,27,7,"2019"
"5105","2019_10_SEA_SF",2019-11-11,"SF","SEA",24,27,-3,"2019"
"5106","2019_11_ARI_SF",2019-11-17,"SF","ARI",36,26,10,"2019"
"5107","2019_11_ATL_CAR",2019-11-17,"CAR","ATL",3,29,-26,"2019"
"5108","2019_11_BUF_MIA",2019-11-17,"MIA","BUF",20,37,-17,"2019"
"5109","2019_11_CHI_LA",2019-11-17,"LA","CHI",17,7,10,"2019"
"5110","2019_11_CIN_OAK",2019-11-17,"LV","CIN",17,10,7,"2019"
"5111","2019_11_DAL_DET",2019-11-17,"DET","DAL",27,35,-8,"2019"
"5112","2019_11_DEN_MIN",2019-11-17,"MIN","DEN",27,23,4,"2019"
"5113","2019_11_HOU_BAL",2019-11-17,"BAL","HOU",41,7,34,"2019"
"5114","2019_11_JAX_IND",2019-11-17,"IND","JAX",33,13,20,"2019"
"5115","2019_11_KC_LAC",2019-11-18,"LAC","KC",17,24,-7,"2019"
"5116","2019_11_NE_PHI",2019-11-17,"PHI","NE",10,17,-7,"2019"
"5117","2019_11_NO_TB",2019-11-17,"TB","NO",17,34,-17,"2019"
"5118","2019_11_NYJ_WAS",2019-11-17,"WAS","NYJ",17,34,-17,"2019"
"5119","2019_11_PIT_CLE",2019-11-14,"CLE","PIT",21,7,14,"2019"
"5120","2019_12_BAL_LA",2019-11-25,"LA","BAL",6,45,-39,"2019"
"5121","2019_12_CAR_NO",2019-11-24,"NO","CAR",34,31,3,"2019"
"5122","2019_12_DAL_NE",2019-11-24,"NE","DAL",13,9,4,"2019"
"5123","2019_12_DEN_BUF",2019-11-24,"BUF","DEN",20,3,17,"2019"
"5124","2019_12_DET_WAS",2019-11-24,"WAS","DET",19,16,3,"2019"
"5125","2019_12_GB_SF",2019-11-24,"SF","GB",37,8,29,"2019"
"5126","2019_12_IND_HOU",2019-11-21,"HOU","IND",20,17,3,"2019"
"5127","2019_12_JAX_TEN",2019-11-24,"TEN","JAX",42,20,22,"2019"
"5128","2019_12_MIA_CLE",2019-11-24,"CLE","MIA",41,24,17,"2019"
"5129","2019_12_NYG_CHI",2019-11-24,"CHI","NYG",19,14,5,"2019"
"5130","2019_12_OAK_NYJ",2019-11-24,"NYJ","LV",34,3,31,"2019"
"5131","2019_12_PIT_CIN",2019-11-24,"CIN","PIT",10,16,-6,"2019"
"5132","2019_12_SEA_PHI",2019-11-24,"PHI","SEA",9,17,-8,"2019"
"5133","2019_12_TB_ATL",2019-11-24,"ATL","TB",22,35,-13,"2019"
"5134","2019_13_BUF_DAL",2019-11-28,"DAL","BUF",15,26,-11,"2019"
"5135","2019_13_CHI_DET",2019-11-28,"DET","CHI",20,24,-4,"2019"
"5136","2019_13_CLE_PIT",2019-12-01,"PIT","CLE",20,13,7,"2019"
"5137","2019_13_GB_NYG",2019-12-01,"NYG","GB",13,31,-18,"2019"
"5138","2019_13_LAC_DEN",2019-12-01,"DEN","LAC",23,20,3,"2019"
"5139","2019_13_LA_ARI",2019-12-01,"ARI","LA",7,34,-27,"2019"
"5140","2019_13_MIN_SEA",2019-12-02,"SEA","MIN",37,30,7,"2019"
"5141","2019_13_NE_HOU",2019-12-01,"HOU","NE",28,22,6,"2019"
"5142","2019_13_NO_ATL",2019-11-28,"ATL","NO",18,26,-8,"2019"
"5143","2019_13_NYJ_CIN",2019-12-01,"CIN","NYJ",22,6,16,"2019"
"5144","2019_13_OAK_KC",2019-12-01,"KC","LV",40,9,31,"2019"
"5145","2019_13_PHI_MIA",2019-12-01,"MIA","PHI",37,31,6,"2019"
"5146","2019_13_SF_BAL",2019-12-01,"BAL","SF",20,17,3,"2019"
"5147","2019_13_TB_JAX",2019-12-01,"JAX","TB",11,28,-17,"2019"
"5148","2019_13_TEN_IND",2019-12-01,"IND","TEN",17,31,-14,"2019"
"5149","2019_13_WAS_CAR",2019-12-01,"CAR","WAS",21,29,-8,"2019"
"5150","2019_14_BAL_BUF",2019-12-08,"BUF","BAL",17,24,-7,"2019"
"5151","2019_14_CAR_ATL",2019-12-08,"ATL","CAR",40,20,20,"2019"
"5152","2019_14_CIN_CLE",2019-12-08,"CLE","CIN",27,19,8,"2019"
"5153","2019_14_DAL_CHI",2019-12-05,"CHI","DAL",31,24,7,"2019"
"5154","2019_14_DEN_HOU",2019-12-08,"HOU","DEN",24,38,-14,"2019"
"5155","2019_14_DET_MIN",2019-12-08,"MIN","DET",20,7,13,"2019"
"5156","2019_14_IND_TB",2019-12-08,"TB","IND",38,35,3,"2019"
"5157","2019_14_KC_NE",2019-12-08,"NE","KC",16,23,-7,"2019"
"5158","2019_14_LAC_JAX",2019-12-08,"JAX","LAC",10,45,-35,"2019"
"5159","2019_14_MIA_NYJ",2019-12-08,"NYJ","MIA",22,21,1,"2019"
"5160","2019_14_NYG_PHI",2019-12-09,"PHI","NYG",23,17,6,"2019"
"5161","2019_14_PIT_ARI",2019-12-08,"ARI","PIT",17,23,-6,"2019"
"5162","2019_14_SEA_LA",2019-12-08,"LA","SEA",28,12,16,"2019"
"5163","2019_14_SF_NO",2019-12-08,"NO","SF",46,48,-2,"2019"
"5164","2019_14_TEN_OAK",2019-12-08,"LV","TEN",21,42,-21,"2019"
"5165","2019_14_WAS_GB",2019-12-08,"GB","WAS",20,15,5,"2019"
"5166","2019_15_ATL_SF",2019-12-15,"SF","ATL",22,29,-7,"2019"
"5167","2019_15_BUF_PIT",2019-12-15,"PIT","BUF",10,17,-7,"2019"
"5168","2019_15_CHI_GB",2019-12-15,"GB","CHI",21,13,8,"2019"
"5169","2019_15_CLE_ARI",2019-12-15,"ARI","CLE",44,31,13,"2019"
"5170","2019_15_DEN_KC",2019-12-15,"KC","DEN",23,3,20,"2019"
"5171","2019_15_HOU_TEN",2019-12-15,"TEN","HOU",21,24,-3,"2019"
"5172","2019_15_IND_NO",2019-12-16,"NO","IND",34,7,27,"2019"
"5173","2019_15_JAX_OAK",2019-12-15,"LV","JAX",16,20,-4,"2019"
"5174","2019_15_LA_DAL",2019-12-15,"DAL","LA",44,21,23,"2019"
"5175","2019_15_MIA_NYG",2019-12-15,"NYG","MIA",36,20,16,"2019"
"5176","2019_15_MIN_LAC",2019-12-15,"LAC","MIN",10,39,-29,"2019"
"5177","2019_15_NE_CIN",2019-12-15,"CIN","NE",13,34,-21,"2019"
"5178","2019_15_NYJ_BAL",2019-12-12,"BAL","NYJ",42,21,21,"2019"
"5179","2019_15_PHI_WAS",2019-12-15,"WAS","PHI",27,37,-10,"2019"
"5180","2019_15_SEA_CAR",2019-12-15,"CAR","SEA",24,30,-6,"2019"
"5181","2019_15_TB_DET",2019-12-15,"DET","TB",17,38,-21,"2019"
"5182","2019_16_ARI_SEA",2019-12-22,"SEA","ARI",13,27,-14,"2019"
"5183","2019_16_BAL_CLE",2019-12-22,"CLE","BAL",15,31,-16,"2019"
"5184","2019_16_BUF_NE",2019-12-21,"NE","BUF",24,17,7,"2019"
"5185","2019_16_CAR_IND",2019-12-22,"IND","CAR",38,6,32,"2019"
"5186","2019_16_CIN_MIA",2019-12-22,"MIA","CIN",38,35,3,"2019"
"5187","2019_16_DAL_PHI",2019-12-22,"PHI","DAL",17,9,8,"2019"
"5188","2019_16_DET_DEN",2019-12-22,"DEN","DET",27,17,10,"2019"
"5189","2019_16_GB_MIN",2019-12-23,"MIN","GB",10,23,-13,"2019"
"5190","2019_16_HOU_TB",2019-12-21,"TB","HOU",20,23,-3,"2019"
"5191","2019_16_JAX_ATL",2019-12-22,"ATL","JAX",24,12,12,"2019"
"5192","2019_16_KC_CHI",2019-12-22,"CHI","KC",3,26,-23,"2019"
"5193","2019_16_LA_SF",2019-12-21,"SF","LA",34,31,3,"2019"
"5194","2019_16_NO_TEN",2019-12-22,"TEN","NO",28,38,-10,"2019"
"5195","2019_16_NYG_WAS",2019-12-22,"WAS","NYG",35,41,-6,"2019"
"5196","2019_16_OAK_LAC",2019-12-22,"LAC","LV",17,24,-7,"2019"
"5197","2019_16_PIT_NYJ",2019-12-22,"NYJ","PIT",16,10,6,"2019"
"5198","2019_17_ARI_LA",2019-12-29,"LA","ARI",31,24,7,"2019"
"5199","2019_17_ATL_TB",2019-12-29,"TB","ATL",22,28,-6,"2019"
"5200","2019_17_CHI_MIN",2019-12-29,"MIN","CHI",19,21,-2,"2019"
"5201","2019_17_CLE_CIN",2019-12-29,"CIN","CLE",33,23,10,"2019"
"5202","2019_17_GB_DET",2019-12-29,"DET","GB",20,23,-3,"2019"
"5203","2019_17_IND_JAX",2019-12-29,"JAX","IND",38,20,18,"2019"
"5204","2019_17_LAC_KC",2019-12-29,"KC","LAC",31,21,10,"2019"
"5205","2019_17_MIA_NE",2019-12-29,"NE","MIA",24,27,-3,"2019"
"5206","2019_17_NO_CAR",2019-12-29,"CAR","NO",10,42,-32,"2019"
"5207","2019_17_NYJ_BUF",2019-12-29,"BUF","NYJ",6,13,-7,"2019"
"5208","2019_17_OAK_DEN",2019-12-29,"DEN","LV",16,15,1,"2019"
"5209","2019_17_PHI_NYG",2019-12-29,"NYG","PHI",17,34,-17,"2019"
"5210","2019_17_PIT_BAL",2019-12-29,"BAL","PIT",28,10,18,"2019"
"5211","2019_17_SF_SEA",2019-12-29,"SEA","SF",21,26,-5,"2019"
"5212","2019_17_TEN_HOU",2019-12-29,"HOU","TEN",14,35,-21,"2019"
"5213","2019_17_WAS_DAL",2019-12-29,"DAL","WAS",47,16,31,"2019"
"5214","2020_01_ARI_SF",2020-09-13,"SF","ARI",20,24,-4,"2020"
"5215","2020_01_CHI_DET",2020-09-13,"DET","CHI",23,27,-4,"2020"
"5216","2020_01_CLE_BAL",2020-09-13,"BAL","CLE",38,6,32,"2020"
"5217","2020_01_DAL_LA",2020-09-13,"LA","DAL",20,17,3,"2020"
"5218","2020_01_GB_MIN",2020-09-13,"MIN","GB",34,43,-9,"2020"
"5219","2020_01_HOU_KC",2020-09-10,"KC","HOU",34,20,14,"2020"
"5220","2020_01_IND_JAX",2020-09-13,"JAX","IND",27,20,7,"2020"
"5221","2020_01_LAC_CIN",2020-09-13,"CIN","LAC",13,16,-3,"2020"
"5222","2020_01_LV_CAR",2020-09-13,"CAR","LV",30,34,-4,"2020"
"5223","2020_01_MIA_NE",2020-09-13,"NE","MIA",21,11,10,"2020"
"5224","2020_01_NYJ_BUF",2020-09-13,"BUF","NYJ",27,17,10,"2020"
"5225","2020_01_PHI_WAS",2020-09-13,"WAS","PHI",27,17,10,"2020"
"5226","2020_01_PIT_NYG",2020-09-14,"NYG","PIT",16,26,-10,"2020"
"5227","2020_01_SEA_ATL",2020-09-13,"ATL","SEA",25,38,-13,"2020"
"5228","2020_01_TB_NO",2020-09-13,"NO","TB",34,23,11,"2020"
"5229","2020_01_TEN_DEN",2020-09-14,"DEN","TEN",14,16,-2,"2020"
"5230","2020_02_ATL_DAL",2020-09-20,"DAL","ATL",40,39,1,"2020"
"5231","2020_02_BAL_HOU",2020-09-20,"HOU","BAL",16,33,-17,"2020"
"5232","2020_02_BUF_MIA",2020-09-20,"MIA","BUF",28,31,-3,"2020"
"5233","2020_02_CAR_TB",2020-09-20,"TB","CAR",31,17,14,"2020"
"5234","2020_02_CIN_CLE",2020-09-17,"CLE","CIN",35,30,5,"2020"
"5235","2020_02_DEN_PIT",2020-09-20,"PIT","DEN",26,21,5,"2020"
"5236","2020_02_DET_GB",2020-09-20,"GB","DET",42,21,21,"2020"
"5237","2020_02_JAX_TEN",2020-09-20,"TEN","JAX",33,30,3,"2020"
"5238","2020_02_KC_LAC",2020-09-20,"LAC","KC",20,23,-3,"2020"
"5239","2020_02_LA_PHI",2020-09-20,"PHI","LA",19,37,-18,"2020"
"5240","2020_02_MIN_IND",2020-09-20,"IND","MIN",28,11,17,"2020"
"5241","2020_02_NE_SEA",2020-09-20,"SEA","NE",35,30,5,"2020"
"5242","2020_02_NO_LV",2020-09-21,"LV","NO",34,24,10,"2020"
"5243","2020_02_NYG_CHI",2020-09-20,"CHI","NYG",17,13,4,"2020"
"5244","2020_02_SF_NYJ",2020-09-20,"NYJ","SF",13,31,-18,"2020"
"5245","2020_02_WAS_ARI",2020-09-20,"ARI","WAS",30,15,15,"2020"
"5246","2020_03_CAR_LAC",2020-09-27,"LAC","CAR",16,21,-5,"2020"
"5247","2020_03_CHI_ATL",2020-09-27,"ATL","CHI",26,30,-4,"2020"
"5248","2020_03_CIN_PHI",2020-09-27,"PHI","CIN",23,23,0,"2020"
"5249","2020_03_DAL_SEA",2020-09-27,"SEA","DAL",38,31,7,"2020"
"5250","2020_03_DET_ARI",2020-09-27,"ARI","DET",23,26,-3,"2020"
"5251","2020_03_GB_NO",2020-09-27,"NO","GB",30,37,-7,"2020"
"5252","2020_03_HOU_PIT",2020-09-27,"PIT","HOU",28,21,7,"2020"
"5253","2020_03_KC_BAL",2020-09-28,"BAL","KC",20,34,-14,"2020"
"5254","2020_03_LA_BUF",2020-09-27,"BUF","LA",35,32,3,"2020"
"5255","2020_03_LV_NE",2020-09-27,"NE","LV",36,20,16,"2020"
"5256","2020_03_MIA_JAX",2020-09-24,"JAX","MIA",13,31,-18,"2020"
"5257","2020_03_NYJ_IND",2020-09-27,"IND","NYJ",36,7,29,"2020"
"5258","2020_03_SF_NYG",2020-09-27,"NYG","SF",9,36,-27,"2020"
"5259","2020_03_TB_DEN",2020-09-27,"DEN","TB",10,28,-18,"2020"
"5260","2020_03_TEN_MIN",2020-09-27,"MIN","TEN",30,31,-1,"2020"
"5261","2020_03_WAS_CLE",2020-09-27,"CLE","WAS",34,20,14,"2020"
"5262","2020_04_ARI_CAR",2020-10-04,"CAR","ARI",31,21,10,"2020"
"5263","2020_04_ATL_GB",2020-10-05,"GB","ATL",30,16,14,"2020"
"5264","2020_04_BAL_WAS",2020-10-04,"WAS","BAL",17,31,-14,"2020"
"5265","2020_04_BUF_LV",2020-10-04,"LV","BUF",23,30,-7,"2020"
"5266","2020_04_CLE_DAL",2020-10-04,"DAL","CLE",38,49,-11,"2020"
"5267","2020_04_DEN_NYJ",2020-10-01,"NYJ","DEN",28,37,-9,"2020"
"5268","2020_04_IND_CHI",2020-10-04,"CHI","IND",11,19,-8,"2020"
"5269","2020_04_JAX_CIN",2020-10-04,"CIN","JAX",33,25,8,"2020"
"5270","2020_04_LAC_TB",2020-10-04,"TB","LAC",38,31,7,"2020"
"5271","2020_04_MIN_HOU",2020-10-04,"HOU","MIN",23,31,-8,"2020"
"5272","2020_04_NE_KC",2020-10-05,"KC","NE",26,10,16,"2020"
"5273","2020_04_NO_DET",2020-10-04,"DET","NO",29,35,-6,"2020"
"5274","2020_04_NYG_LA",2020-10-04,"LA","NYG",17,9,8,"2020"
"5275","2020_04_PHI_SF",2020-10-04,"SF","PHI",20,25,-5,"2020"
"5276","2020_04_SEA_MIA",2020-10-04,"MIA","SEA",23,31,-8,"2020"
"5277","2020_05_ARI_NYJ",2020-10-11,"NYJ","ARI",10,30,-20,"2020"
"5278","2020_05_BUF_TEN",2020-10-13,"TEN","BUF",42,16,26,"2020"
"5279","2020_05_CAR_ATL",2020-10-11,"ATL","CAR",16,23,-7,"2020"
"5280","2020_05_CIN_BAL",2020-10-11,"BAL","CIN",27,3,24,"2020"
"5281","2020_05_IND_CLE",2020-10-11,"CLE","IND",32,23,9,"2020"
"5282","2020_05_JAX_HOU",2020-10-11,"HOU","JAX",30,14,16,"2020"
"5283","2020_05_LAC_NO",2020-10-12,"NO","LAC",30,27,3,"2020"
"5284","2020_05_LA_WAS",2020-10-11,"WAS","LA",10,30,-20,"2020"
"5285","2020_05_LV_KC",2020-10-11,"KC","LV",32,40,-8,"2020"
"5286","2020_05_MIA_SF",2020-10-11,"SF","MIA",17,43,-26,"2020"
"5287","2020_05_MIN_SEA",2020-10-11,"SEA","MIN",27,26,1,"2020"
"5288","2020_05_NYG_DAL",2020-10-11,"DAL","NYG",37,34,3,"2020"
"5289","2020_05_PHI_PIT",2020-10-11,"PIT","PHI",38,29,9,"2020"
"5290","2020_05_TB_CHI",2020-10-08,"CHI","TB",20,19,1,"2020"
"5291","2020_06_ARI_DAL",2020-10-19,"DAL","ARI",10,38,-28,"2020"
"5292","2020_06_ATL_MIN",2020-10-18,"MIN","ATL",23,40,-17,"2020"
"5293","2020_06_BAL_PHI",2020-10-18,"PHI","BAL",28,30,-2,"2020"
"5294","2020_06_CHI_CAR",2020-10-18,"CAR","CHI",16,23,-7,"2020"
"5295","2020_06_CIN_IND",2020-10-18,"IND","CIN",31,27,4,"2020"
"5296","2020_06_CLE_PIT",2020-10-18,"PIT","CLE",38,7,31,"2020"
"5297","2020_06_DEN_NE",2020-10-18,"NE","DEN",12,18,-6,"2020"
"5298","2020_06_DET_JAX",2020-10-18,"JAX","DET",16,34,-18,"2020"
"5299","2020_06_GB_TB",2020-10-18,"TB","GB",38,10,28,"2020"
"5300","2020_06_HOU_TEN",2020-10-18,"TEN","HOU",42,36,6,"2020"
"5301","2020_06_KC_BUF",2020-10-19,"BUF","KC",17,26,-9,"2020"
"5302","2020_06_LA_SF",2020-10-18,"SF","LA",24,16,8,"2020"
"5303","2020_06_NYJ_MIA",2020-10-18,"MIA","NYJ",24,0,24,"2020"
"5304","2020_06_WAS_NYG",2020-10-18,"NYG","WAS",20,19,1,"2020"
"5305","2020_07_BUF_NYJ",2020-10-25,"NYJ","BUF",10,18,-8,"2020"
"5306","2020_07_CAR_NO",2020-10-25,"NO","CAR",27,24,3,"2020"
"5307","2020_07_CHI_LA",2020-10-26,"LA","CHI",24,10,14,"2020"
"5308","2020_07_CLE_CIN",2020-10-25,"CIN","CLE",34,37,-3,"2020"
"5309","2020_07_DAL_WAS",2020-10-25,"WAS","DAL",25,3,22,"2020"
"5310","2020_07_DET_ATL",2020-10-25,"ATL","DET",22,23,-1,"2020"
"5311","2020_07_GB_HOU",2020-10-25,"HOU","GB",20,35,-15,"2020"
"5312","2020_07_JAX_LAC",2020-10-25,"LAC","JAX",39,29,10,"2020"
"5313","2020_07_KC_DEN",2020-10-25,"DEN","KC",16,43,-27,"2020"
"5314","2020_07_NYG_PHI",2020-10-22,"PHI","NYG",22,21,1,"2020"
"5315","2020_07_PIT_TEN",2020-10-25,"TEN","PIT",24,27,-3,"2020"
"5316","2020_07_SEA_ARI",2020-10-25,"ARI","SEA",37,34,3,"2020"
"5317","2020_07_SF_NE",2020-10-25,"NE","SF",6,33,-27,"2020"
"5318","2020_07_TB_LV",2020-10-25,"LV","TB",20,45,-25,"2020"
"5319","2020_08_ATL_CAR",2020-10-29,"CAR","ATL",17,25,-8,"2020"
"5320","2020_08_DAL_PHI",2020-11-01,"PHI","DAL",23,9,14,"2020"
"5321","2020_08_IND_DET",2020-11-01,"DET","IND",21,41,-20,"2020"
"5322","2020_08_LAC_DEN",2020-11-01,"DEN","LAC",31,30,1,"2020"
"5323","2020_08_LA_MIA",2020-11-01,"MIA","LA",28,17,11,"2020"
"5324","2020_08_LV_CLE",2020-11-01,"CLE","LV",6,16,-10,"2020"
"5325","2020_08_MIN_GB",2020-11-01,"GB","MIN",22,28,-6,"2020"
"5326","2020_08_NE_BUF",2020-11-01,"BUF","NE",24,21,3,"2020"
"5327","2020_08_NO_CHI",2020-11-01,"CHI","NO",23,26,-3,"2020"
"5328","2020_08_NYJ_KC",2020-11-01,"KC","NYJ",35,9,26,"2020"
"5329","2020_08_PIT_BAL",2020-11-01,"BAL","PIT",24,28,-4,"2020"
"5330","2020_08_SF_SEA",2020-11-01,"SEA","SF",37,27,10,"2020"
"5331","2020_08_TB_NYG",2020-11-02,"NYG","TB",23,25,-2,"2020"
"5332","2020_08_TEN_CIN",2020-11-01,"CIN","TEN",31,20,11,"2020"
"5333","2020_09_BAL_IND",2020-11-08,"IND","BAL",10,24,-14,"2020"
"5334","2020_09_CAR_KC",2020-11-08,"KC","CAR",33,31,2,"2020"
"5335","2020_09_CHI_TEN",2020-11-08,"TEN","CHI",24,17,7,"2020"
"5336","2020_09_DEN_ATL",2020-11-08,"ATL","DEN",34,27,7,"2020"
"5337","2020_09_DET_MIN",2020-11-08,"MIN","DET",34,20,14,"2020"
"5338","2020_09_GB_SF",2020-11-05,"SF","GB",17,34,-17,"2020"
"5339","2020_09_HOU_JAX",2020-11-08,"JAX","HOU",25,27,-2,"2020"
"5340","2020_09_LV_LAC",2020-11-08,"LAC","LV",26,31,-5,"2020"
"5341","2020_09_MIA_ARI",2020-11-08,"ARI","MIA",31,34,-3,"2020"
"5342","2020_09_NE_NYJ",2020-11-09,"NYJ","NE",27,30,-3,"2020"
"5343","2020_09_NO_TB",2020-11-08,"TB","NO",3,38,-35,"2020"
"5344","2020_09_NYG_WAS",2020-11-08,"WAS","NYG",20,23,-3,"2020"
"5345","2020_09_PIT_DAL",2020-11-08,"DAL","PIT",19,24,-5,"2020"
"5346","2020_09_SEA_BUF",2020-11-08,"BUF","SEA",44,34,10,"2020"
"5347","2020_10_BAL_NE",2020-11-15,"NE","BAL",23,17,6,"2020"
"5348","2020_10_BUF_ARI",2020-11-15,"ARI","BUF",32,30,2,"2020"
"5349","2020_10_CIN_PIT",2020-11-15,"PIT","CIN",36,10,26,"2020"
"5350","2020_10_DEN_LV",2020-11-15,"LV","DEN",37,12,25,"2020"
"5351","2020_10_HOU_CLE",2020-11-15,"CLE","HOU",10,7,3,"2020"
"5352","2020_10_IND_TEN",2020-11-12,"TEN","IND",17,34,-17,"2020"
"5353","2020_10_JAX_GB",2020-11-15,"GB","JAX",24,20,4,"2020"
"5354","2020_10_LAC_MIA",2020-11-15,"MIA","LAC",29,21,8,"2020"
"5355","2020_10_MIN_CHI",2020-11-16,"CHI","MIN",13,19,-6,"2020"
"5356","2020_10_PHI_NYG",2020-11-15,"NYG","PHI",27,17,10,"2020"
"5357","2020_10_SEA_LA",2020-11-15,"LA","SEA",23,16,7,"2020"
"5358","2020_10_SF_NO",2020-11-15,"NO","SF",27,13,14,"2020"
"5359","2020_10_TB_CAR",2020-11-15,"CAR","TB",23,46,-23,"2020"
"5360","2020_10_WAS_DET",2020-11-15,"DET","WAS",30,27,3,"2020"
"5361","2020_11_ARI_SEA",2020-11-19,"SEA","ARI",28,21,7,"2020"
"5362","2020_11_ATL_NO",2020-11-22,"NO","ATL",24,9,15,"2020"
"5363","2020_11_CIN_WAS",2020-11-22,"WAS","CIN",20,9,11,"2020"
"5364","2020_11_DAL_MIN",2020-11-22,"MIN","DAL",28,31,-3,"2020"
"5365","2020_11_DET_CAR",2020-11-22,"CAR","DET",20,0,20,"2020"
"5366","2020_11_GB_IND",2020-11-22,"IND","GB",34,31,3,"2020"
"5367","2020_11_KC_LV",2020-11-22,"LV","KC",31,35,-4,"2020"
"5368","2020_11_LA_TB",2020-11-23,"TB","LA",24,27,-3,"2020"
"5369","2020_11_MIA_DEN",2020-11-22,"DEN","MIA",20,13,7,"2020"
"5370","2020_11_NE_HOU",2020-11-22,"HOU","NE",27,20,7,"2020"
"5371","2020_11_NYJ_LAC",2020-11-22,"LAC","NYJ",34,28,6,"2020"
"5372","2020_11_PHI_CLE",2020-11-22,"CLE","PHI",22,17,5,"2020"
"5373","2020_11_PIT_JAX",2020-11-22,"JAX","PIT",3,27,-24,"2020"
"5374","2020_11_TEN_BAL",2020-11-22,"BAL","TEN",24,30,-6,"2020"
"5375","2020_12_ARI_NE",2020-11-29,"NE","ARI",20,17,3,"2020"
"5376","2020_12_BAL_PIT",2020-12-02,"PIT","BAL",19,14,5,"2020"
"5377","2020_12_CAR_MIN",2020-11-29,"MIN","CAR",28,27,1,"2020"
"5378","2020_12_CHI_GB",2020-11-29,"GB","CHI",41,25,16,"2020"
"5379","2020_12_CLE_JAX",2020-11-29,"JAX","CLE",25,27,-2,"2020"
"5380","2020_12_HOU_DET",2020-11-26,"DET","HOU",25,41,-16,"2020"
"5381","2020_12_KC_TB",2020-11-29,"TB","KC",24,27,-3,"2020"
"5382","2020_12_LAC_BUF",2020-11-29,"BUF","LAC",27,17,10,"2020"
"5383","2020_12_LV_ATL",2020-11-29,"ATL","LV",43,6,37,"2020"
"5384","2020_12_MIA_NYJ",2020-11-29,"NYJ","MIA",3,20,-17,"2020"
"5385","2020_12_NO_DEN",2020-11-29,"DEN","NO",3,31,-28,"2020"
"5386","2020_12_NYG_CIN",2020-11-29,"CIN","NYG",17,19,-2,"2020"
"5387","2020_12_SEA_PHI",2020-11-30,"PHI","SEA",17,23,-6,"2020"
"5388","2020_12_SF_LA",2020-11-29,"LA","SF",20,23,-3,"2020"
"5389","2020_12_TEN_IND",2020-11-29,"IND","TEN",26,45,-19,"2020"
"5390","2020_12_WAS_DAL",2020-11-26,"DAL","WAS",16,41,-25,"2020"
"5391","2020_13_BUF_SF",2020-12-07,"SF","BUF",24,34,-10,"2020"
"5392","2020_13_CIN_MIA",2020-12-06,"MIA","CIN",19,7,12,"2020"
"5393","2020_13_CLE_TEN",2020-12-06,"TEN","CLE",35,41,-6,"2020"
"5394","2020_13_DAL_BAL",2020-12-08,"BAL","DAL",34,17,17,"2020"
"5395","2020_13_DEN_KC",2020-12-06,"KC","DEN",22,16,6,"2020"
"5396","2020_13_DET_CHI",2020-12-06,"CHI","DET",30,34,-4,"2020"
"5397","2020_13_IND_HOU",2020-12-06,"HOU","IND",20,26,-6,"2020"
"5398","2020_13_JAX_MIN",2020-12-06,"MIN","JAX",27,24,3,"2020"
"5399","2020_13_LA_ARI",2020-12-06,"ARI","LA",28,38,-10,"2020"
"5400","2020_13_LV_NYJ",2020-12-06,"NYJ","LV",28,31,-3,"2020"
"5401","2020_13_NE_LAC",2020-12-06,"LAC","NE",0,45,-45,"2020"
"5402","2020_13_NO_ATL",2020-12-06,"ATL","NO",16,21,-5,"2020"
"5403","2020_13_NYG_SEA",2020-12-06,"SEA","NYG",12,17,-5,"2020"
"5404","2020_13_PHI_GB",2020-12-06,"GB","PHI",30,16,14,"2020"
"5405","2020_13_WAS_PIT",2020-12-07,"PIT","WAS",17,23,-6,"2020"
"5406","2020_14_ARI_NYG",2020-12-13,"NYG","ARI",7,26,-19,"2020"
"5407","2020_14_ATL_LAC",2020-12-13,"LAC","ATL",20,17,3,"2020"
"5408","2020_14_BAL_CLE",2020-12-14,"CLE","BAL",42,47,-5,"2020"
"5409","2020_14_DAL_CIN",2020-12-13,"CIN","DAL",7,30,-23,"2020"
"5410","2020_14_DEN_CAR",2020-12-13,"CAR","DEN",27,32,-5,"2020"
"5411","2020_14_GB_DET",2020-12-13,"DET","GB",24,31,-7,"2020"
"5412","2020_14_HOU_CHI",2020-12-13,"CHI","HOU",36,7,29,"2020"
"5413","2020_14_IND_LV",2020-12-13,"LV","IND",27,44,-17,"2020"
"5414","2020_14_KC_MIA",2020-12-13,"MIA","KC",27,33,-6,"2020"
"5415","2020_14_MIN_TB",2020-12-13,"TB","MIN",26,14,12,"2020"
"5416","2020_14_NE_LA",2020-12-10,"LA","NE",24,3,21,"2020"
"5417","2020_14_NO_PHI",2020-12-13,"PHI","NO",24,21,3,"2020"
"5418","2020_14_NYJ_SEA",2020-12-13,"SEA","NYJ",40,3,37,"2020"
"5419","2020_14_PIT_BUF",2020-12-13,"BUF","PIT",26,15,11,"2020"
"5420","2020_14_TEN_JAX",2020-12-13,"JAX","TEN",10,31,-21,"2020"
"5421","2020_14_WAS_SF",2020-12-13,"SF","WAS",15,23,-8,"2020"
"5422","2020_15_BUF_DEN",2020-12-19,"DEN","BUF",19,48,-29,"2020"
"5423","2020_15_CAR_GB",2020-12-19,"GB","CAR",24,16,8,"2020"
"5424","2020_15_CHI_MIN",2020-12-20,"MIN","CHI",27,33,-6,"2020"
"5425","2020_15_CLE_NYG",2020-12-20,"NYG","CLE",6,20,-14,"2020"
"5426","2020_15_DET_TEN",2020-12-20,"TEN","DET",46,25,21,"2020"
"5427","2020_15_HOU_IND",2020-12-20,"IND","HOU",27,20,7,"2020"
"5428","2020_15_JAX_BAL",2020-12-20,"BAL","JAX",40,14,26,"2020"
"5429","2020_15_KC_NO",2020-12-20,"NO","KC",29,32,-3,"2020"
"5430","2020_15_LAC_LV",2020-12-17,"LV","LAC",27,30,-3,"2020"
"5431","2020_15_NE_MIA",2020-12-20,"MIA","NE",22,12,10,"2020"
"5432","2020_15_NYJ_LA",2020-12-20,"LA","NYJ",20,23,-3,"2020"
"5433","2020_15_PHI_ARI",2020-12-20,"ARI","PHI",33,26,7,"2020"
"5434","2020_15_PIT_CIN",2020-12-21,"CIN","PIT",27,17,10,"2020"
"5435","2020_15_SEA_WAS",2020-12-20,"WAS","SEA",15,20,-5,"2020"
"5436","2020_15_SF_DAL",2020-12-20,"DAL","SF",41,33,8,"2020"
"5437","2020_15_TB_ATL",2020-12-20,"ATL","TB",27,31,-4,"2020"
"5438","2020_16_ATL_KC",2020-12-27,"KC","ATL",17,14,3,"2020"
"5439","2020_16_BUF_NE",2020-12-28,"NE","BUF",9,38,-29,"2020"
"5440","2020_16_CAR_WAS",2020-12-27,"WAS","CAR",13,20,-7,"2020"
"5441","2020_16_CHI_JAX",2020-12-27,"JAX","CHI",17,41,-24,"2020"
"5442","2020_16_CIN_HOU",2020-12-27,"HOU","CIN",31,37,-6,"2020"
"5443","2020_16_CLE_NYJ",2020-12-27,"NYJ","CLE",23,16,7,"2020"
"5444","2020_16_DEN_LAC",2020-12-27,"LAC","DEN",19,16,3,"2020"
"5445","2020_16_IND_PIT",2020-12-27,"PIT","IND",28,24,4,"2020"
"5446","2020_16_LA_SEA",2020-12-27,"SEA","LA",20,9,11,"2020"
"5447","2020_16_MIA_LV",2020-12-26,"LV","MIA",25,26,-1,"2020"
"5448","2020_16_MIN_NO",2020-12-25,"NO","MIN",52,33,19,"2020"
"5449","2020_16_NYG_BAL",2020-12-27,"BAL","NYG",27,13,14,"2020"
"5450","2020_16_PHI_DAL",2020-12-27,"DAL","PHI",37,17,20,"2020"
"5451","2020_16_SF_ARI",2020-12-26,"ARI","SF",12,20,-8,"2020"
"5452","2020_16_TB_DET",2020-12-26,"DET","TB",7,47,-40,"2020"
"5453","2020_16_TEN_GB",2020-12-27,"GB","TEN",40,14,26,"2020"
"5454","2021_01_ARI_TEN",2021-09-12,"TEN","ARI",13,38,-25,"2021"
"5455","2021_01_BAL_LV",2021-09-13,"LV","BAL",33,27,6,"2021"
"5456","2021_01_CHI_LA",2021-09-12,"LA","CHI",34,14,20,"2021"
"5457","2021_01_CLE_KC",2021-09-12,"KC","CLE",33,29,4,"2021"
"5458","2021_01_DAL_TB",2021-09-09,"TB","DAL",31,29,2,"2021"
"5459","2021_01_DEN_NYG",2021-09-12,"NYG","DEN",13,27,-14,"2021"
"5460","2021_01_GB_NO",2021-09-12,"NO","GB",38,3,35,"2021"
"5461","2021_01_JAX_HOU",2021-09-12,"HOU","JAX",37,21,16,"2021"
"5462","2021_01_LAC_WAS",2021-09-12,"WAS","LAC",16,20,-4,"2021"
"5463","2021_01_MIA_NE",2021-09-12,"NE","MIA",16,17,-1,"2021"
"5464","2021_01_MIN_CIN",2021-09-12,"CIN","MIN",27,24,3,"2021"
"5465","2021_01_NYJ_CAR",2021-09-12,"CAR","NYJ",19,14,5,"2021"
"5466","2021_01_PHI_ATL",2021-09-12,"ATL","PHI",6,32,-26,"2021"
"5467","2021_01_PIT_BUF",2021-09-12,"BUF","PIT",16,23,-7,"2021"
"5468","2021_01_SEA_IND",2021-09-12,"IND","SEA",16,28,-12,"2021"
"5469","2021_01_SF_DET",2021-09-12,"DET","SF",33,41,-8,"2021"
"5470","2021_02_ATL_TB",2021-09-19,"TB","ATL",48,25,23,"2021"
"5471","2021_02_BUF_MIA",2021-09-19,"MIA","BUF",0,35,-35,"2021"
"5472","2021_02_CIN_CHI",2021-09-19,"CHI","CIN",20,17,3,"2021"
"5473","2021_02_DAL_LAC",2021-09-19,"LAC","DAL",17,20,-3,"2021"
"5474","2021_02_DEN_JAX",2021-09-19,"JAX","DEN",13,23,-10,"2021"
"5475","2021_02_DET_GB",2021-09-20,"GB","DET",35,17,18,"2021"
"5476","2021_02_HOU_CLE",2021-09-19,"CLE","HOU",31,21,10,"2021"
"5477","2021_02_KC_BAL",2021-09-19,"BAL","KC",36,35,1,"2021"
"5478","2021_02_LA_IND",2021-09-19,"IND","LA",24,27,-3,"2021"
"5479","2021_02_LV_PIT",2021-09-19,"PIT","LV",17,26,-9,"2021"
"5480","2021_02_MIN_ARI",2021-09-19,"ARI","MIN",34,33,1,"2021"
"5481","2021_02_NE_NYJ",2021-09-19,"NYJ","NE",6,25,-19,"2021"
"5482","2021_02_NO_CAR",2021-09-19,"CAR","NO",26,7,19,"2021"
"5483","2021_02_NYG_WAS",2021-09-16,"WAS","NYG",30,29,1,"2021"
"5484","2021_02_SF_PHI",2021-09-19,"PHI","SF",11,17,-6,"2021"
"5485","2021_02_TEN_SEA",2021-09-19,"SEA","TEN",30,33,-3,"2021"
"5486","2021_03_ARI_JAX",2021-09-26,"JAX","ARI",19,31,-12,"2021"
"5487","2021_03_ATL_NYG",2021-09-26,"NYG","ATL",14,17,-3,"2021"
"5488","2021_03_BAL_DET",2021-09-26,"DET","BAL",17,19,-2,"2021"
"5489","2021_03_CAR_HOU",2021-09-23,"HOU","CAR",9,24,-15,"2021"
"5490","2021_03_CHI_CLE",2021-09-26,"CLE","CHI",26,6,20,"2021"
"5491","2021_03_CIN_PIT",2021-09-26,"PIT","CIN",10,24,-14,"2021"
"5492","2021_03_GB_SF",2021-09-26,"SF","GB",28,30,-2,"2021"
"5493","2021_03_IND_TEN",2021-09-26,"TEN","IND",25,16,9,"2021"
"5494","2021_03_LAC_KC",2021-09-26,"KC","LAC",24,30,-6,"2021"
"5495","2021_03_MIA_LV",2021-09-26,"LV","MIA",31,28,3,"2021"
"5496","2021_03_NO_NE",2021-09-26,"NE","NO",13,28,-15,"2021"
"5497","2021_03_NYJ_DEN",2021-09-26,"DEN","NYJ",26,0,26,"2021"
"5498","2021_03_PHI_DAL",2021-09-27,"DAL","PHI",41,21,20,"2021"
"5499","2021_03_SEA_MIN",2021-09-26,"MIN","SEA",30,17,13,"2021"
"5500","2021_03_TB_LA",2021-09-26,"LA","TB",34,24,10,"2021"
"5501","2021_03_WAS_BUF",2021-09-26,"BUF","WAS",43,21,22,"2021"
"5502","2021_04_ARI_LA",2021-10-03,"LA","ARI",20,37,-17,"2021"
"5503","2021_04_BAL_DEN",2021-10-03,"DEN","BAL",7,23,-16,"2021"
"5504","2021_04_CAR_DAL",2021-10-03,"DAL","CAR",36,28,8,"2021"
"5505","2021_04_CLE_MIN",2021-10-03,"MIN","CLE",7,14,-7,"2021"
"5506","2021_04_DET_CHI",2021-10-03,"CHI","DET",24,14,10,"2021"
"5507","2021_04_HOU_BUF",2021-10-03,"BUF","HOU",40,0,40,"2021"
"5508","2021_04_IND_MIA",2021-10-03,"MIA","IND",17,27,-10,"2021"
"5509","2021_04_JAX_CIN",2021-09-30,"CIN","JAX",24,21,3,"2021"
"5510","2021_04_KC_PHI",2021-10-03,"PHI","KC",30,42,-12,"2021"
"5511","2021_04_LV_LAC",2021-10-04,"LAC","LV",28,14,14,"2021"
"5512","2021_04_NYG_NO",2021-10-03,"NO","NYG",21,27,-6,"2021"
"5513","2021_04_PIT_GB",2021-10-03,"GB","PIT",27,17,10,"2021"
"5514","2021_04_SEA_SF",2021-10-03,"SF","SEA",21,28,-7,"2021"
"5515","2021_04_TB_NE",2021-10-03,"NE","TB",17,19,-2,"2021"
"5516","2021_04_TEN_NYJ",2021-10-03,"NYJ","TEN",27,24,3,"2021"
"5517","2021_04_WAS_ATL",2021-10-03,"ATL","WAS",30,34,-4,"2021"
"5518","2021_05_BUF_KC",2021-10-10,"KC","BUF",20,38,-18,"2021"
"5519","2021_05_CHI_LV",2021-10-10,"LV","CHI",9,20,-11,"2021"
"5520","2021_05_CLE_LAC",2021-10-10,"LAC","CLE",47,42,5,"2021"
"5521","2021_05_DEN_PIT",2021-10-10,"PIT","DEN",27,19,8,"2021"
"5522","2021_05_DET_MIN",2021-10-10,"MIN","DET",19,17,2,"2021"
"5523","2021_05_GB_CIN",2021-10-10,"CIN","GB",22,25,-3,"2021"
"5524","2021_05_IND_BAL",2021-10-11,"BAL","IND",31,25,6,"2021"
"5525","2021_05_LA_SEA",2021-10-07,"SEA","LA",17,26,-9,"2021"
"5526","2021_05_MIA_TB",2021-10-10,"TB","MIA",45,17,28,"2021"
"5527","2021_05_NE_HOU",2021-10-10,"HOU","NE",22,25,-3,"2021"
"5528","2021_05_NO_WAS",2021-10-10,"WAS","NO",22,33,-11,"2021"
"5529","2021_05_NYG_DAL",2021-10-10,"DAL","NYG",44,20,24,"2021"
"5530","2021_05_NYJ_ATL",2021-10-10,"ATL","NYJ",27,20,7,"2021"
"5531","2021_05_PHI_CAR",2021-10-10,"CAR","PHI",18,21,-3,"2021"
"5532","2021_05_SF_ARI",2021-10-10,"ARI","SF",17,10,7,"2021"
"5533","2021_05_TEN_JAX",2021-10-10,"JAX","TEN",19,37,-18,"2021"
"5534","2021_06_ARI_CLE",2021-10-17,"CLE","ARI",14,37,-23,"2021"
"5535","2021_06_BUF_TEN",2021-10-18,"TEN","BUF",34,31,3,"2021"
"5536","2021_06_CIN_DET",2021-10-17,"DET","CIN",11,34,-23,"2021"
"5537","2021_06_DAL_NE",2021-10-17,"NE","DAL",29,35,-6,"2021"
"5538","2021_06_GB_CHI",2021-10-17,"CHI","GB",14,24,-10,"2021"
"5539","2021_06_HOU_IND",2021-10-17,"IND","HOU",31,3,28,"2021"
"5540","2021_06_KC_WAS",2021-10-17,"WAS","KC",13,31,-18,"2021"
"5541","2021_06_LAC_BAL",2021-10-17,"BAL","LAC",34,6,28,"2021"
"5542","2021_06_LA_NYG",2021-10-17,"NYG","LA",11,38,-27,"2021"
"5543","2021_06_LV_DEN",2021-10-17,"DEN","LV",24,34,-10,"2021"
"5544","2021_06_MIA_JAX",2021-10-17,"JAX","MIA",23,20,3,"2021"
"5545","2021_06_MIN_CAR",2021-10-17,"CAR","MIN",28,34,-6,"2021"
"5546","2021_06_SEA_PIT",2021-10-17,"PIT","SEA",23,20,3,"2021"
"5547","2021_06_TB_PHI",2021-10-14,"PHI","TB",22,28,-6,"2021"
"5548","2021_07_ATL_MIA",2021-10-24,"MIA","ATL",28,30,-2,"2021"
"5549","2021_07_CAR_NYG",2021-10-24,"NYG","CAR",25,3,22,"2021"
"5550","2021_07_CHI_TB",2021-10-24,"TB","CHI",38,3,35,"2021"
"5551","2021_07_CIN_BAL",2021-10-24,"BAL","CIN",17,41,-24,"2021"
"5552","2021_07_DEN_CLE",2021-10-21,"CLE","DEN",17,14,3,"2021"
"5553","2021_07_DET_LA",2021-10-24,"LA","DET",28,19,9,"2021"
"5554","2021_07_HOU_ARI",2021-10-24,"ARI","HOU",31,5,26,"2021"
"5555","2021_07_IND_SF",2021-10-24,"SF","IND",18,30,-12,"2021"
"5556","2021_07_KC_TEN",2021-10-24,"TEN","KC",27,3,24,"2021"
"5557","2021_07_NO_SEA",2021-10-25,"SEA","NO",10,13,-3,"2021"
"5558","2021_07_NYJ_NE",2021-10-24,"NE","NYJ",54,13,41,"2021"
"5559","2021_07_PHI_LV",2021-10-24,"LV","PHI",33,22,11,"2021"
"5560","2021_07_WAS_GB",2021-10-24,"GB","WAS",24,10,14,"2021"
"5561","2021_08_CAR_ATL",2021-10-31,"ATL","CAR",13,19,-6,"2021"
"5562","2021_08_CIN_NYJ",2021-10-31,"NYJ","CIN",34,31,3,"2021"
"5563","2021_08_DAL_MIN",2021-10-31,"MIN","DAL",16,20,-4,"2021"
"5564","2021_08_GB_ARI",2021-10-28,"ARI","GB",21,24,-3,"2021"
"5565","2021_08_JAX_SEA",2021-10-31,"SEA","JAX",31,7,24,"2021"
"5566","2021_08_LA_HOU",2021-10-31,"HOU","LA",22,38,-16,"2021"
"5567","2021_08_MIA_BUF",2021-10-31,"BUF","MIA",26,11,15,"2021"
"5568","2021_08_NE_LAC",2021-10-31,"LAC","NE",24,27,-3,"2021"
"5569","2021_08_NYG_KC",2021-11-01,"KC","NYG",20,17,3,"2021"
"5570","2021_08_PHI_DET",2021-10-31,"DET","PHI",6,44,-38,"2021"
"5571","2021_08_PIT_CLE",2021-10-31,"CLE","PIT",10,15,-5,"2021"
"5572","2021_08_SF_CHI",2021-10-31,"CHI","SF",22,33,-11,"2021"
"5573","2021_08_TB_NO",2021-10-31,"NO","TB",36,27,9,"2021"
"5574","2021_08_TEN_IND",2021-10-31,"IND","TEN",31,34,-3,"2021"
"5575","2021_08_WAS_DEN",2021-10-31,"DEN","WAS",17,10,7,"2021"
"5576","2021_09_ARI_SF",2021-11-07,"SF","ARI",17,31,-14,"2021"
"5577","2021_09_ATL_NO",2021-11-07,"NO","ATL",25,27,-2,"2021"
"5578","2021_09_BUF_JAX",2021-11-07,"JAX","BUF",9,6,3,"2021"
"5579","2021_09_CHI_PIT",2021-11-08,"PIT","CHI",29,27,2,"2021"
"5580","2021_09_CLE_CIN",2021-11-07,"CIN","CLE",16,41,-25,"2021"
"5581","2021_09_DEN_DAL",2021-11-07,"DAL","DEN",16,30,-14,"2021"
"5582","2021_09_GB_KC",2021-11-07,"KC","GB",13,7,6,"2021"
"5583","2021_09_HOU_MIA",2021-11-07,"MIA","HOU",17,9,8,"2021"
"5584","2021_09_LAC_PHI",2021-11-07,"PHI","LAC",24,27,-3,"2021"
"5585","2021_09_LV_NYG",2021-11-07,"NYG","LV",23,16,7,"2021"
"5586","2021_09_MIN_BAL",2021-11-07,"BAL","MIN",34,31,3,"2021"
"5587","2021_09_NE_CAR",2021-11-07,"CAR","NE",6,24,-18,"2021"
"5588","2021_09_NYJ_IND",2021-11-04,"IND","NYJ",45,30,15,"2021"
"5589","2021_09_TEN_LA",2021-11-07,"LA","TEN",16,28,-12,"2021"
"5590","2021_10_ATL_DAL",2021-11-14,"DAL","ATL",43,3,40,"2021"
"5591","2021_10_BAL_MIA",2021-11-11,"MIA","BAL",22,10,12,"2021"
"5592","2021_10_BUF_NYJ",2021-11-14,"NYJ","BUF",17,45,-28,"2021"
"5593","2021_10_CAR_ARI",2021-11-14,"ARI","CAR",10,34,-24,"2021"
"5594","2021_10_CLE_NE",2021-11-14,"NE","CLE",45,7,38,"2021"
"5595","2021_10_DET_PIT",2021-11-14,"PIT","DET",16,16,0,"2021"
"5596","2021_10_JAX_IND",2021-11-14,"IND","JAX",23,17,6,"2021"
"5597","2021_10_KC_LV",2021-11-14,"LV","KC",14,41,-27,"2021"
"5598","2021_10_LA_SF",2021-11-15,"SF","LA",31,10,21,"2021"
"5599","2021_10_MIN_LAC",2021-11-14,"LAC","MIN",20,27,-7,"2021"
"5600","2021_10_NO_TEN",2021-11-14,"TEN","NO",23,21,2,"2021"
"5601","2021_10_PHI_DEN",2021-11-14,"DEN","PHI",13,30,-17,"2021"
"5602","2021_10_SEA_GB",2021-11-14,"GB","SEA",17,0,17,"2021"
"5603","2021_10_TB_WAS",2021-11-14,"WAS","TB",29,19,10,"2021"
"5604","2021_11_ARI_SEA",2021-11-21,"SEA","ARI",13,23,-10,"2021"
"5605","2021_11_BAL_CHI",2021-11-21,"CHI","BAL",13,16,-3,"2021"
"5606","2021_11_CIN_LV",2021-11-21,"LV","CIN",13,32,-19,"2021"
"5607","2021_11_DAL_KC",2021-11-21,"KC","DAL",19,9,10,"2021"
"5608","2021_11_DET_CLE",2021-11-21,"CLE","DET",13,10,3,"2021"
"5609","2021_11_GB_MIN",2021-11-21,"MIN","GB",34,31,3,"2021"
"5610","2021_11_HOU_TEN",2021-11-21,"TEN","HOU",13,22,-9,"2021"
"5611","2021_11_IND_BUF",2021-11-21,"BUF","IND",15,41,-26,"2021"
"5612","2021_11_MIA_NYJ",2021-11-21,"NYJ","MIA",17,24,-7,"2021"
"5613","2021_11_NE_ATL",2021-11-18,"ATL","NE",0,25,-25,"2021"
"5614","2021_11_NO_PHI",2021-11-21,"PHI","NO",40,29,11,"2021"
"5615","2021_11_NYG_TB",2021-11-22,"TB","NYG",30,10,20,"2021"
"5616","2021_11_PIT_LAC",2021-11-21,"LAC","PIT",41,37,4,"2021"
"5617","2021_11_SF_JAX",2021-11-21,"JAX","SF",10,30,-20,"2021"
"5618","2021_11_WAS_CAR",2021-11-21,"CAR","WAS",21,27,-6,"2021"
"5619","2021_12_ATL_JAX",2021-11-28,"JAX","ATL",14,21,-7,"2021"
"5620","2021_12_BUF_NO",2021-11-25,"NO","BUF",6,31,-25,"2021"
"5621","2021_12_CAR_MIA",2021-11-28,"MIA","CAR",33,10,23,"2021"
"5622","2021_12_CHI_DET",2021-11-25,"DET","CHI",14,16,-2,"2021"
"5623","2021_12_CLE_BAL",2021-11-28,"BAL","CLE",16,10,6,"2021"
"5624","2021_12_LAC_DEN",2021-11-28,"DEN","LAC",28,13,15,"2021"
"5625","2021_12_LA_GB",2021-11-28,"GB","LA",36,28,8,"2021"
"5626","2021_12_LV_DAL",2021-11-25,"DAL","LV",33,36,-3,"2021"
"5627","2021_12_MIN_SF",2021-11-28,"SF","MIN",34,26,8,"2021"
"5628","2021_12_NYJ_HOU",2021-11-28,"HOU","NYJ",14,21,-7,"2021"
"5629","2021_12_PHI_NYG",2021-11-28,"NYG","PHI",13,7,6,"2021"
"5630","2021_12_PIT_CIN",2021-11-28,"CIN","PIT",41,10,31,"2021"
"5631","2021_12_SEA_WAS",2021-11-29,"WAS","SEA",17,15,2,"2021"
"5632","2021_12_TB_IND",2021-11-28,"IND","TB",31,38,-7,"2021"
"5633","2021_12_TEN_NE",2021-11-28,"NE","TEN",36,13,23,"2021"
"5634","2021_13_ARI_CHI",2021-12-05,"CHI","ARI",22,33,-11,"2021"
"5635","2021_13_BAL_PIT",2021-12-05,"PIT","BAL",20,19,1,"2021"
"5636","2021_13_DAL_NO",2021-12-02,"NO","DAL",17,27,-10,"2021"
"5637","2021_13_DEN_KC",2021-12-05,"KC","DEN",22,9,13,"2021"
"5638","2021_13_IND_HOU",2021-12-05,"HOU","IND",0,31,-31,"2021"
"5639","2021_13_JAX_LA",2021-12-05,"LA","JAX",37,7,30,"2021"
"5640","2021_13_LAC_CIN",2021-12-05,"CIN","LAC",22,41,-19,"2021"
"5641","2021_13_MIN_DET",2021-12-05,"DET","MIN",29,27,2,"2021"
"5642","2021_13_NE_BUF",2021-12-06,"BUF","NE",10,14,-4,"2021"
"5643","2021_13_NYG_MIA",2021-12-05,"MIA","NYG",20,9,11,"2021"
"5644","2021_13_PHI_NYJ",2021-12-05,"NYJ","PHI",18,33,-15,"2021"
"5645","2021_13_SF_SEA",2021-12-05,"SEA","SF",30,23,7,"2021"
"5646","2021_13_TB_ATL",2021-12-05,"ATL","TB",17,30,-13,"2021"
"5647","2021_13_WAS_LV",2021-12-05,"LV","WAS",15,17,-2,"2021"
"5648","2021_14_ATL_CAR",2021-12-12,"CAR","ATL",21,29,-8,"2021"
"5649","2021_14_BAL_CLE",2021-12-12,"CLE","BAL",24,22,2,"2021"
"5650","2021_14_BUF_TB",2021-12-12,"TB","BUF",33,27,6,"2021"
"5651","2021_14_CHI_GB",2021-12-12,"GB","CHI",45,30,15,"2021"
"5652","2021_14_DAL_WAS",2021-12-12,"WAS","DAL",20,27,-7,"2021"
"5653","2021_14_DET_DEN",2021-12-12,"DEN","DET",38,10,28,"2021"
"5654","2021_14_JAX_TEN",2021-12-12,"TEN","JAX",20,0,20,"2021"
"5655","2021_14_LA_ARI",2021-12-13,"ARI","LA",23,30,-7,"2021"
"5656","2021_14_LV_KC",2021-12-12,"KC","LV",48,9,39,"2021"
"5657","2021_14_NO_NYJ",2021-12-12,"NYJ","NO",9,30,-21,"2021"
"5658","2021_14_NYG_LAC",2021-12-12,"LAC","NYG",37,21,16,"2021"
"5659","2021_14_PIT_MIN",2021-12-09,"MIN","PIT",36,28,8,"2021"
"5660","2021_14_SEA_HOU",2021-12-12,"HOU","SEA",13,33,-20,"2021"
"5661","2021_14_SF_CIN",2021-12-12,"CIN","SF",23,26,-3,"2021"
"5662","2021_15_ARI_DET",2021-12-19,"DET","ARI",30,12,18,"2021"
"5663","2021_15_ATL_SF",2021-12-19,"SF","ATL",31,13,18,"2021"
"5664","2021_15_CAR_BUF",2021-12-19,"BUF","CAR",31,14,17,"2021"
"5665","2021_15_CIN_DEN",2021-12-19,"DEN","CIN",10,15,-5,"2021"
"5666","2021_15_DAL_NYG",2021-12-19,"NYG","DAL",6,21,-15,"2021"
"5667","2021_15_GB_BAL",2021-12-19,"BAL","GB",30,31,-1,"2021"
"5668","2021_15_HOU_JAX",2021-12-19,"JAX","HOU",16,30,-14,"2021"
"5669","2021_15_KC_LAC",2021-12-16,"LAC","KC",28,34,-6,"2021"
"5670","2021_15_LV_CLE",2021-12-20,"CLE","LV",14,16,-2,"2021"
"5671","2021_15_MIN_CHI",2021-12-20,"CHI","MIN",9,17,-8,"2021"
"5672","2021_15_NE_IND",2021-12-18,"IND","NE",27,17,10,"2021"
"5673","2021_15_NO_TB",2021-12-19,"TB","NO",0,9,-9,"2021"
"5674","2021_15_NYJ_MIA",2021-12-19,"MIA","NYJ",31,24,7,"2021"
"5675","2021_15_SEA_LA",2021-12-21,"LA","SEA",20,10,10,"2021"
"5676","2021_15_TEN_PIT",2021-12-19,"PIT","TEN",19,13,6,"2021"
"5677","2021_15_WAS_PHI",2021-12-21,"PHI","WAS",27,17,10,"2021"
"5678","2021_16_BAL_CIN",2021-12-26,"CIN","BAL",41,21,20,"2021"
"5679","2021_16_BUF_NE",2021-12-26,"NE","BUF",21,33,-12,"2021"
"5680","2021_16_CHI_SEA",2021-12-26,"SEA","CHI",24,25,-1,"2021"
"5681","2021_16_CLE_GB",2021-12-25,"GB","CLE",24,22,2,"2021"
"5682","2021_16_DEN_LV",2021-12-26,"LV","DEN",17,13,4,"2021"
"5683","2021_16_DET_ATL",2021-12-26,"ATL","DET",20,16,4,"2021"
"5684","2021_16_IND_ARI",2021-12-25,"ARI","IND",16,22,-6,"2021"
"5685","2021_16_JAX_NYJ",2021-12-26,"NYJ","JAX",26,21,5,"2021"
"5686","2021_16_LAC_HOU",2021-12-26,"HOU","LAC",41,29,12,"2021"
"5687","2021_16_LA_MIN",2021-12-26,"MIN","LA",23,30,-7,"2021"
"5688","2021_16_MIA_NO",2021-12-27,"NO","MIA",3,20,-17,"2021"
"5689","2021_16_NYG_PHI",2021-12-26,"PHI","NYG",34,10,24,"2021"
"5690","2021_16_PIT_KC",2021-12-26,"KC","PIT",36,10,26,"2021"
"5691","2021_16_SF_TEN",2021-12-23,"TEN","SF",20,17,3,"2021"
"5692","2021_16_TB_CAR",2021-12-26,"CAR","TB",6,32,-26,"2021"
"5693","2021_16_WAS_DAL",2021-12-26,"DAL","WAS",56,14,42,"2021"
"5694","2022_01_BAL_NYJ",2022-09-11,"NYJ","BAL",9,24,-15,"2022"
"5695","2022_01_BUF_LA",2022-09-08,"LA","BUF",10,31,-21,"2022"
"5696","2022_01_CLE_CAR",2022-09-11,"CAR","CLE",24,26,-2,"2022"
"5697","2022_01_DEN_SEA",2022-09-12,"SEA","DEN",17,16,1,"2022"
"5698","2022_01_GB_MIN",2022-09-11,"MIN","GB",23,7,16,"2022"
"5699","2022_01_IND_HOU",2022-09-11,"HOU","IND",20,20,0,"2022"
"5700","2022_01_JAX_WAS",2022-09-11,"WAS","JAX",28,22,6,"2022"
"5701","2022_01_KC_ARI",2022-09-11,"ARI","KC",21,44,-23,"2022"
"5702","2022_01_LV_LAC",2022-09-11,"LAC","LV",24,19,5,"2022"
"5703","2022_01_NE_MIA",2022-09-11,"MIA","NE",20,7,13,"2022"
"5704","2022_01_NO_ATL",2022-09-11,"ATL","NO",26,27,-1,"2022"
"5705","2022_01_NYG_TEN",2022-09-11,"TEN","NYG",20,21,-1,"2022"
"5706","2022_01_PHI_DET",2022-09-11,"DET","PHI",35,38,-3,"2022"
"5707","2022_01_PIT_CIN",2022-09-11,"CIN","PIT",20,23,-3,"2022"
"5708","2022_01_SF_CHI",2022-09-11,"CHI","SF",19,10,9,"2022"
"5709","2022_01_TB_DAL",2022-09-11,"DAL","TB",3,19,-16,"2022"
"5710","2022_02_ARI_LV",2022-09-18,"LV","ARI",23,29,-6,"2022"
"5711","2022_02_ATL_LA",2022-09-18,"LA","ATL",31,27,4,"2022"
"5712","2022_02_CAR_NYG",2022-09-18,"NYG","CAR",19,16,3,"2022"
"5713","2022_02_CHI_GB",2022-09-18,"GB","CHI",27,10,17,"2022"
"5714","2022_02_CIN_DAL",2022-09-18,"DAL","CIN",20,17,3,"2022"
"5715","2022_02_HOU_DEN",2022-09-18,"DEN","HOU",16,9,7,"2022"
"5716","2022_02_IND_JAX",2022-09-18,"JAX","IND",24,0,24,"2022"
"5717","2022_02_LAC_KC",2022-09-15,"KC","LAC",27,24,3,"2022"
"5718","2022_02_MIA_BAL",2022-09-18,"BAL","MIA",38,42,-4,"2022"
"5719","2022_02_MIN_PHI",2022-09-19,"PHI","MIN",24,7,17,"2022"
"5720","2022_02_NE_PIT",2022-09-18,"PIT","NE",14,17,-3,"2022"
"5721","2022_02_NYJ_CLE",2022-09-18,"CLE","NYJ",30,31,-1,"2022"
"5722","2022_02_SEA_SF",2022-09-18,"SF","SEA",27,7,20,"2022"
"5723","2022_02_TB_NO",2022-09-18,"NO","TB",10,20,-10,"2022"
"5724","2022_02_TEN_BUF",2022-09-19,"BUF","TEN",41,7,34,"2022"
"5725","2022_02_WAS_DET",2022-09-18,"DET","WAS",36,27,9,"2022"
"5726","2022_03_ATL_SEA",2022-09-25,"SEA","ATL",23,27,-4,"2022"
"5727","2022_03_BAL_NE",2022-09-25,"NE","BAL",26,37,-11,"2022"
"5728","2022_03_BUF_MIA",2022-09-25,"MIA","BUF",21,19,2,"2022"
"5729","2022_03_CIN_NYJ",2022-09-25,"NYJ","CIN",12,27,-15,"2022"
"5730","2022_03_DAL_NYG",2022-09-26,"NYG","DAL",16,23,-7,"2022"
"5731","2022_03_DET_MIN",2022-09-25,"MIN","DET",28,24,4,"2022"
"5732","2022_03_GB_TB",2022-09-25,"TB","GB",12,14,-2,"2022"
"5733","2022_03_HOU_CHI",2022-09-25,"CHI","HOU",23,20,3,"2022"
"5734","2022_03_JAX_LAC",2022-09-25,"LAC","JAX",10,38,-28,"2022"
"5735","2022_03_KC_IND",2022-09-25,"IND","KC",20,17,3,"2022"
"5736","2022_03_LA_ARI",2022-09-25,"ARI","LA",12,20,-8,"2022"
"5737","2022_03_LV_TEN",2022-09-25,"TEN","LV",24,22,2,"2022"
"5738","2022_03_NO_CAR",2022-09-25,"CAR","NO",22,14,8,"2022"
"5739","2022_03_PHI_WAS",2022-09-25,"WAS","PHI",8,24,-16,"2022"
"5740","2022_03_PIT_CLE",2022-09-22,"CLE","PIT",29,17,12,"2022"
"5741","2022_03_SF_DEN",2022-09-25,"DEN","SF",11,10,1,"2022"
"5742","2022_04_ARI_CAR",2022-10-02,"CAR","ARI",16,26,-10,"2022"
"5743","2022_04_BUF_BAL",2022-10-02,"BAL","BUF",20,23,-3,"2022"
"5744","2022_04_CHI_NYG",2022-10-02,"NYG","CHI",20,12,8,"2022"
"5745","2022_04_CLE_ATL",2022-10-02,"ATL","CLE",23,20,3,"2022"
"5746","2022_04_DEN_LV",2022-10-02,"LV","DEN",32,23,9,"2022"
"5747","2022_04_JAX_PHI",2022-10-02,"PHI","JAX",29,21,8,"2022"
"5748","2022_04_KC_TB",2022-10-02,"TB","KC",31,41,-10,"2022"
"5749","2022_04_LAC_HOU",2022-10-02,"HOU","LAC",24,34,-10,"2022"
"5750","2022_04_LA_SF",2022-10-03,"SF","LA",24,9,15,"2022"
"5751","2022_04_MIA_CIN",2022-09-29,"CIN","MIA",27,15,12,"2022"
"5752","2022_04_MIN_NO",2022-10-02,"NO","MIN",25,28,-3,"2022"
"5753","2022_04_NE_GB",2022-10-02,"GB","NE",27,24,3,"2022"
"5754","2022_04_NYJ_PIT",2022-10-02,"PIT","NYJ",20,24,-4,"2022"
"5755","2022_04_SEA_DET",2022-10-02,"DET","SEA",45,48,-3,"2022"
"5756","2022_04_TEN_IND",2022-10-02,"IND","TEN",17,24,-7,"2022"
"5757","2022_04_WAS_DAL",2022-10-02,"DAL","WAS",25,10,15,"2022"
"5758","2022_05_ATL_TB",2022-10-09,"TB","ATL",21,15,6,"2022"
"5759","2022_05_CHI_MIN",2022-10-09,"MIN","CHI",29,22,7,"2022"
"5760","2022_05_CIN_BAL",2022-10-09,"BAL","CIN",19,17,2,"2022"
"5761","2022_05_DAL_LA",2022-10-09,"LA","DAL",10,22,-12,"2022"
"5762","2022_05_DET_NE",2022-10-09,"NE","DET",29,0,29,"2022"
"5763","2022_05_HOU_JAX",2022-10-09,"JAX","HOU",6,13,-7,"2022"
"5764","2022_05_IND_DEN",2022-10-06,"DEN","IND",9,12,-3,"2022"
"5765","2022_05_LAC_CLE",2022-10-09,"CLE","LAC",28,30,-2,"2022"
"5766","2022_05_LV_KC",2022-10-10,"KC","LV",30,29,1,"2022"
"5767","2022_05_MIA_NYJ",2022-10-09,"NYJ","MIA",40,17,23,"2022"
"5768","2022_05_NYG_GB",2022-10-09,"GB","NYG",22,27,-5,"2022"
"5769","2022_05_PHI_ARI",2022-10-09,"ARI","PHI",17,20,-3,"2022"
"5770","2022_05_PIT_BUF",2022-10-09,"BUF","PIT",38,3,35,"2022"
"5771","2022_05_SEA_NO",2022-10-09,"NO","SEA",39,32,7,"2022"
"5772","2022_05_SF_CAR",2022-10-09,"CAR","SF",15,37,-22,"2022"
"5773","2022_05_TEN_WAS",2022-10-09,"WAS","TEN",17,21,-4,"2022"
"5774","2022_06_ARI_SEA",2022-10-16,"SEA","ARI",19,9,10,"2022"
"5775","2022_06_BAL_NYG",2022-10-16,"NYG","BAL",24,20,4,"2022"
"5776","2022_06_BUF_KC",2022-10-16,"KC","BUF",20,24,-4,"2022"
"5777","2022_06_CAR_LA",2022-10-16,"LA","CAR",24,10,14,"2022"
"5778","2022_06_CIN_NO",2022-10-16,"NO","CIN",26,30,-4,"2022"
"5779","2022_06_DAL_PHI",2022-10-16,"PHI","DAL",26,17,9,"2022"
"5780","2022_06_DEN_LAC",2022-10-17,"LAC","DEN",19,16,3,"2022"
"5781","2022_06_JAX_IND",2022-10-16,"IND","JAX",34,27,7,"2022"
"5782","2022_06_MIN_MIA",2022-10-16,"MIA","MIN",16,24,-8,"2022"
"5783","2022_06_NE_CLE",2022-10-16,"CLE","NE",15,38,-23,"2022"
"5784","2022_06_NYJ_GB",2022-10-16,"GB","NYJ",10,27,-17,"2022"
"5785","2022_06_SF_ATL",2022-10-16,"ATL","SF",28,14,14,"2022"
"5786","2022_06_TB_PIT",2022-10-16,"PIT","TB",20,18,2,"2022"
"5787","2022_06_WAS_CHI",2022-10-13,"CHI","WAS",7,12,-5,"2022"
"5788","2022_07_ATL_CIN",2022-10-23,"CIN","ATL",35,17,18,"2022"
"5789","2022_07_CHI_NE",2022-10-24,"NE","CHI",14,33,-19,"2022"
"5790","2022_07_CLE_BAL",2022-10-23,"BAL","CLE",23,20,3,"2022"
"5791","2022_07_DET_DAL",2022-10-23,"DAL","DET",24,6,18,"2022"
"5792","2022_07_GB_WAS",2022-10-23,"WAS","GB",23,21,2,"2022"
"5793","2022_07_HOU_LV",2022-10-23,"LV","HOU",38,20,18,"2022"
"5794","2022_07_IND_TEN",2022-10-23,"TEN","IND",19,10,9,"2022"
"5795","2022_07_KC_SF",2022-10-23,"SF","KC",23,44,-21,"2022"
"5796","2022_07_NO_ARI",2022-10-20,"ARI","NO",42,34,8,"2022"
"5797","2022_07_NYG_JAX",2022-10-23,"JAX","NYG",17,23,-6,"2022"
"5798","2022_07_NYJ_DEN",2022-10-23,"DEN","NYJ",9,16,-7,"2022"
"5799","2022_07_PIT_MIA",2022-10-23,"MIA","PIT",16,10,6,"2022"
"5800","2022_07_SEA_LAC",2022-10-23,"LAC","SEA",23,37,-14,"2022"
"5801","2022_07_TB_CAR",2022-10-23,"CAR","TB",21,3,18,"2022"
"5802","2022_08_ARI_MIN",2022-10-30,"MIN","ARI",34,26,8,"2022"
"5803","2022_08_BAL_TB",2022-10-27,"TB","BAL",22,27,-5,"2022"
"5804","2022_08_CAR_ATL",2022-10-30,"ATL","CAR",37,34,3,"2022"
"5805","2022_08_CHI_DAL",2022-10-30,"DAL","CHI",49,29,20,"2022"
"5806","2022_08_CIN_CLE",2022-10-31,"CLE","CIN",32,13,19,"2022"
"5807","2022_08_DEN_JAX",2022-10-30,"JAX","DEN",17,21,-4,"2022"
"5808","2022_08_GB_BUF",2022-10-30,"BUF","GB",27,17,10,"2022"
"5809","2022_08_LV_NO",2022-10-30,"NO","LV",24,0,24,"2022"
"5810","2022_08_MIA_DET",2022-10-30,"DET","MIA",27,31,-4,"2022"
"5811","2022_08_NE_NYJ",2022-10-30,"NYJ","NE",17,22,-5,"2022"
"5812","2022_08_NYG_SEA",2022-10-30,"SEA","NYG",27,13,14,"2022"
"5813","2022_08_PIT_PHI",2022-10-30,"PHI","PIT",35,13,22,"2022"
"5814","2022_08_SF_LA",2022-10-30,"LA","SF",14,31,-17,"2022"
"5815","2022_08_TEN_HOU",2022-10-30,"HOU","TEN",10,17,-7,"2022"
"5816","2022_08_WAS_IND",2022-10-30,"IND","WAS",16,17,-1,"2022"
"5817","2022_09_BAL_NO",2022-11-07,"NO","BAL",13,27,-14,"2022"
"5818","2022_09_BUF_NYJ",2022-11-06,"NYJ","BUF",20,17,3,"2022"
"5819","2022_09_CAR_CIN",2022-11-06,"CIN","CAR",42,21,21,"2022"
"5820","2022_09_GB_DET",2022-11-06,"DET","GB",15,9,6,"2022"
"5821","2022_09_IND_NE",2022-11-06,"NE","IND",26,3,23,"2022"
"5822","2022_09_LAC_ATL",2022-11-06,"ATL","LAC",17,20,-3,"2022"
"5823","2022_09_LA_TB",2022-11-06,"TB","LA",16,13,3,"2022"
"5824","2022_09_LV_JAX",2022-11-06,"JAX","LV",27,20,7,"2022"
"5825","2022_09_MIA_CHI",2022-11-06,"CHI","MIA",32,35,-3,"2022"
"5826","2022_09_MIN_WAS",2022-11-06,"WAS","MIN",17,20,-3,"2022"
"5827","2022_09_PHI_HOU",2022-11-03,"HOU","PHI",17,29,-12,"2022"
"5828","2022_09_SEA_ARI",2022-11-06,"ARI","SEA",21,31,-10,"2022"
"5829","2022_09_TEN_KC",2022-11-06,"KC","TEN",20,17,3,"2022"
"5830","2022_10_ARI_LA",2022-11-13,"LA","ARI",17,27,-10,"2022"
"5831","2022_10_ATL_CAR",2022-11-10,"CAR","ATL",25,15,10,"2022"
"5832","2022_10_CLE_MIA",2022-11-13,"MIA","CLE",39,17,22,"2022"
"5833","2022_10_DAL_GB",2022-11-13,"GB","DAL",31,28,3,"2022"
"5834","2022_10_DEN_TEN",2022-11-13,"TEN","DEN",17,10,7,"2022"
"5835","2022_10_DET_CHI",2022-11-13,"CHI","DET",30,31,-1,"2022"
"5836","2022_10_HOU_NYG",2022-11-13,"NYG","HOU",24,16,8,"2022"
"5837","2022_10_IND_LV",2022-11-13,"LV","IND",20,25,-5,"2022"
"5838","2022_10_JAX_KC",2022-11-13,"KC","JAX",27,17,10,"2022"
"5839","2022_10_LAC_SF",2022-11-13,"SF","LAC",22,16,6,"2022"
"5840","2022_10_MIN_BUF",2022-11-13,"BUF","MIN",30,33,-3,"2022"
"5841","2022_10_NO_PIT",2022-11-13,"PIT","NO",20,10,10,"2022"
"5842","2022_10_SEA_TB",2022-11-13,"TB","SEA",21,16,5,"2022"
"5843","2022_10_WAS_PHI",2022-11-14,"PHI","WAS",21,32,-11,"2022"
"5844","2022_11_CAR_BAL",2022-11-20,"BAL","CAR",13,3,10,"2022"
"5845","2022_11_CHI_ATL",2022-11-20,"ATL","CHI",27,24,3,"2022"
"5846","2022_11_CIN_PIT",2022-11-20,"PIT","CIN",30,37,-7,"2022"
"5847","2022_11_CLE_BUF",2022-11-20,"BUF","CLE",31,23,8,"2022"
"5848","2022_11_DAL_MIN",2022-11-20,"MIN","DAL",3,40,-37,"2022"
"5849","2022_11_DET_NYG",2022-11-20,"NYG","DET",18,31,-13,"2022"
"5850","2022_11_KC_LAC",2022-11-20,"LAC","KC",27,30,-3,"2022"
"5851","2022_11_LA_NO",2022-11-20,"NO","LA",27,20,7,"2022"
"5852","2022_11_LV_DEN",2022-11-20,"DEN","LV",16,22,-6,"2022"
"5853","2022_11_NYJ_NE",2022-11-20,"NE","NYJ",10,3,7,"2022"
"5854","2022_11_PHI_IND",2022-11-20,"IND","PHI",16,17,-1,"2022"
"5855","2022_11_SF_ARI",2022-11-21,"ARI","SF",10,38,-28,"2022"
"5856","2022_11_TEN_GB",2022-11-17,"GB","TEN",17,27,-10,"2022"
"5857","2022_11_WAS_HOU",2022-11-20,"HOU","WAS",10,23,-13,"2022"
"5858","2022_12_ATL_WAS",2022-11-27,"WAS","ATL",19,13,6,"2022"
"5859","2022_12_BAL_JAX",2022-11-27,"JAX","BAL",28,27,1,"2022"
"5860","2022_12_BUF_DET",2022-11-24,"DET","BUF",25,28,-3,"2022"
"5861","2022_12_CHI_NYJ",2022-11-27,"NYJ","CHI",31,10,21,"2022"
"5862","2022_12_CIN_TEN",2022-11-27,"TEN","CIN",16,20,-4,"2022"
"5863","2022_12_DEN_CAR",2022-11-27,"CAR","DEN",23,10,13,"2022"
"5864","2022_12_GB_PHI",2022-11-27,"PHI","GB",40,33,7,"2022"
"5865","2022_12_HOU_MIA",2022-11-27,"MIA","HOU",30,15,15,"2022"
"5866","2022_12_LAC_ARI",2022-11-27,"ARI","LAC",24,25,-1,"2022"
"5867","2022_12_LA_KC",2022-11-27,"KC","LA",26,10,16,"2022"
"5868","2022_12_LV_SEA",2022-11-27,"SEA","LV",34,40,-6,"2022"
"5869","2022_12_NE_MIN",2022-11-24,"MIN","NE",33,26,7,"2022"
"5870","2022_12_NO_SF",2022-11-27,"SF","NO",13,0,13,"2022"
"5871","2022_12_NYG_DAL",2022-11-24,"DAL","NYG",28,20,8,"2022"
"5872","2022_12_PIT_IND",2022-11-28,"IND","PIT",17,24,-7,"2022"
"5873","2022_12_TB_CLE",2022-11-27,"CLE","TB",23,17,6,"2022"
"5874","2022_13_BUF_NE",2022-12-01,"NE","BUF",10,24,-14,"2022"
"5875","2022_13_CLE_HOU",2022-12-04,"HOU","CLE",14,27,-13,"2022"
"5876","2022_13_DEN_BAL",2022-12-04,"BAL","DEN",10,9,1,"2022"
"5877","2022_13_GB_CHI",2022-12-04,"CHI","GB",19,28,-9,"2022"
"5878","2022_13_IND_DAL",2022-12-04,"DAL","IND",54,19,35,"2022"
"5879","2022_13_JAX_DET",2022-12-04,"DET","JAX",40,14,26,"2022"
"5880","2022_13_KC_CIN",2022-12-04,"CIN","KC",27,24,3,"2022"
"5881","2022_13_LAC_LV",2022-12-04,"LV","LAC",27,20,7,"2022"
"5882","2022_13_MIA_SF",2022-12-04,"SF","MIA",33,17,16,"2022"
"5883","2022_13_NO_TB",2022-12-05,"TB","NO",17,16,1,"2022"
"5884","2022_13_NYJ_MIN",2022-12-04,"MIN","NYJ",27,22,5,"2022"
"5885","2022_13_PIT_ATL",2022-12-04,"ATL","PIT",16,19,-3,"2022"
"5886","2022_13_SEA_LA",2022-12-04,"LA","SEA",23,27,-4,"2022"
"5887","2022_13_TEN_PHI",2022-12-04,"PHI","TEN",35,10,25,"2022"
"5888","2022_13_WAS_NYG",2022-12-04,"NYG","WAS",20,20,0,"2022"
"5889","2022_14_BAL_PIT",2022-12-11,"PIT","BAL",14,16,-2,"2022"
"5890","2022_14_CAR_SEA",2022-12-11,"SEA","CAR",24,30,-6,"2022"
"5891","2022_14_CLE_CIN",2022-12-11,"CIN","CLE",23,10,13,"2022"
"5892","2022_14_HOU_DAL",2022-12-11,"DAL","HOU",27,23,4,"2022"
"5893","2022_14_JAX_TEN",2022-12-11,"TEN","JAX",22,36,-14,"2022"
"5894","2022_14_KC_DEN",2022-12-11,"DEN","KC",28,34,-6,"2022"
"5895","2022_14_LV_LA",2022-12-08,"LA","LV",17,16,1,"2022"
"5896","2022_14_MIA_LAC",2022-12-11,"LAC","MIA",23,17,6,"2022"
"5897","2022_14_MIN_DET",2022-12-11,"DET","MIN",34,23,11,"2022"
"5898","2022_14_NE_ARI",2022-12-12,"ARI","NE",13,27,-14,"2022"
"5899","2022_14_NYJ_BUF",2022-12-11,"BUF","NYJ",20,12,8,"2022"
"5900","2022_14_PHI_NYG",2022-12-11,"NYG","PHI",22,48,-26,"2022"
"5901","2022_14_TB_SF",2022-12-11,"SF","TB",35,7,28,"2022"
"5902","2022_15_ARI_DEN",2022-12-18,"DEN","ARI",24,15,9,"2022"
"5903","2022_15_ATL_NO",2022-12-18,"NO","ATL",21,18,3,"2022"
"5904","2022_15_BAL_CLE",2022-12-17,"CLE","BAL",13,3,10,"2022"
"5905","2022_15_CIN_TB",2022-12-18,"TB","CIN",23,34,-11,"2022"
"5906","2022_15_DAL_JAX",2022-12-18,"JAX","DAL",40,34,6,"2022"
"5907","2022_15_DET_NYJ",2022-12-18,"NYJ","DET",17,20,-3,"2022"
"5908","2022_15_IND_MIN",2022-12-17,"MIN","IND",39,36,3,"2022"
"5909","2022_15_KC_HOU",2022-12-18,"HOU","KC",24,30,-6,"2022"
"5910","2022_15_LA_GB",2022-12-19,"GB","LA",24,12,12,"2022"
"5911","2022_15_MIA_BUF",2022-12-17,"BUF","MIA",32,29,3,"2022"
"5912","2022_15_NE_LV",2022-12-18,"LV","NE",30,24,6,"2022"
"5913","2022_15_NYG_WAS",2022-12-18,"WAS","NYG",12,20,-8,"2022"
"5914","2022_15_PHI_CHI",2022-12-18,"CHI","PHI",20,25,-5,"2022"
"5915","2022_15_PIT_CAR",2022-12-18,"CAR","PIT",16,24,-8,"2022"
"5916","2022_15_SF_SEA",2022-12-15,"SEA","SF",13,21,-8,"2022"
"5917","2022_15_TEN_LAC",2022-12-18,"LAC","TEN",17,14,3,"2022"
"5918","2022_16_ATL_BAL",2022-12-24,"BAL","ATL",17,9,8,"2022"
"5919","2022_16_BUF_CHI",2022-12-24,"CHI","BUF",13,35,-22,"2022"
"5920","2022_16_CIN_NE",2022-12-24,"NE","CIN",18,22,-4,"2022"
"5921","2022_16_DEN_LA",2022-12-25,"LA","DEN",51,14,37,"2022"
"5922","2022_16_DET_CAR",2022-12-24,"CAR","DET",37,23,14,"2022"
"5923","2022_16_GB_MIA",2022-12-25,"MIA","GB",20,26,-6,"2022"
"5924","2022_16_HOU_TEN",2022-12-24,"TEN","HOU",14,19,-5,"2022"
"5925","2022_16_JAX_NYJ",2022-12-22,"NYJ","JAX",3,19,-16,"2022"
"5926","2022_16_LAC_IND",2022-12-26,"IND","LAC",3,20,-17,"2022"
"5927","2022_16_LV_PIT",2022-12-24,"PIT","LV",13,10,3,"2022"
"5928","2022_16_NO_CLE",2022-12-24,"CLE","NO",10,17,-7,"2022"
"5929","2022_16_NYG_MIN",2022-12-24,"MIN","NYG",27,24,3,"2022"
"5930","2022_16_PHI_DAL",2022-12-24,"DAL","PHI",40,34,6,"2022"
"5931","2022_16_SEA_KC",2022-12-24,"KC","SEA",24,10,14,"2022"
"5932","2022_16_TB_ARI",2022-12-25,"ARI","TB",16,19,-3,"2022"
"5933","2022_16_WAS_SF",2022-12-24,"SF","WAS",37,20,17,"2022"
"5934","2022_17_DAL_TEN",2022-12-29,"TEN","DAL",13,27,-14,"2022"
"5935","2023_01_ARI_WAS",2023-09-10,"WAS","ARI",20,16,4,"2023"
"5936","2023_01_BUF_NYJ",2023-09-11,"NYJ","BUF",22,16,6,"2023"
"5937","2023_01_CAR_ATL",2023-09-10,"ATL","CAR",24,10,14,"2023"
"5938","2023_01_CIN_CLE",2023-09-10,"CLE","CIN",24,3,21,"2023"
"5939","2023_01_DAL_NYG",2023-09-10,"NYG","DAL",0,40,-40,"2023"
"5940","2023_01_DET_KC",2023-09-07,"KC","DET",20,21,-1,"2023"
"5941","2023_01_GB_CHI",2023-09-10,"CHI","GB",20,38,-18,"2023"
"5942","2023_01_HOU_BAL",2023-09-10,"BAL","HOU",25,9,16,"2023"
"5943","2023_01_JAX_IND",2023-09-10,"IND","JAX",21,31,-10,"2023"
"5944","2023_01_LA_SEA",2023-09-10,"SEA","LA",13,30,-17,"2023"
"5945","2023_01_LV_DEN",2023-09-10,"DEN","LV",16,17,-1,"2023"
"5946","2023_01_MIA_LAC",2023-09-10,"LAC","MIA",34,36,-2,"2023"
"5947","2023_01_PHI_NE",2023-09-10,"NE","PHI",20,25,-5,"2023"
"5948","2023_01_SF_PIT",2023-09-10,"PIT","SF",7,30,-23,"2023"
"5949","2023_01_TB_MIN",2023-09-10,"MIN","TB",17,20,-3,"2023"
"5950","2023_01_TEN_NO",2023-09-10,"NO","TEN",16,15,1,"2023"
"5951","2023_02_BAL_CIN",2023-09-17,"CIN","BAL",24,27,-3,"2023"
"5952","2023_02_CHI_TB",2023-09-17,"TB","CHI",27,17,10,"2023"
"5953","2023_02_CLE_PIT",2023-09-18,"PIT","CLE",26,22,4,"2023"
"5954","2023_02_GB_ATL",2023-09-17,"ATL","GB",25,24,1,"2023"
"5955","2023_02_IND_HOU",2023-09-17,"HOU","IND",20,31,-11,"2023"
"5956","2023_02_KC_JAX",2023-09-17,"JAX","KC",9,17,-8,"2023"
"5957","2023_02_LAC_TEN",2023-09-17,"TEN","LAC",27,24,3,"2023"
"5958","2023_02_LV_BUF",2023-09-17,"BUF","LV",38,10,28,"2023"
"5959","2023_02_MIA_NE",2023-09-17,"NE","MIA",17,24,-7,"2023"
"5960","2023_02_MIN_PHI",2023-09-14,"PHI","MIN",34,28,6,"2023"
"5961","2023_02_NO_CAR",2023-09-18,"CAR","NO",17,20,-3,"2023"
"5962","2023_02_NYG_ARI",2023-09-17,"ARI","NYG",28,31,-3,"2023"
"5963","2023_02_NYJ_DAL",2023-09-17,"DAL","NYJ",30,10,20,"2023"
"5964","2023_02_SEA_DET",2023-09-17,"DET","SEA",31,37,-6,"2023"
"5965","2023_02_SF_LA",2023-09-17,"LA","SF",23,30,-7,"2023"
"5966","2023_02_WAS_DEN",2023-09-17,"DEN","WAS",33,35,-2,"2023"
"5967","2023_03_ATL_DET",2023-09-24,"DET","ATL",20,6,14,"2023"
"5968","2023_03_BUF_WAS",2023-09-24,"WAS","BUF",3,37,-34,"2023"
"5969","2023_03_CAR_SEA",2023-09-24,"SEA","CAR",37,27,10,"2023"
"5970","2023_03_CHI_KC",2023-09-24,"KC","CHI",41,10,31,"2023"
"5971","2023_03_DAL_ARI",2023-09-24,"ARI","DAL",28,16,12,"2023"
"5972","2023_03_DEN_MIA",2023-09-24,"MIA","DEN",70,20,50,"2023"
"5973","2023_03_HOU_JAX",2023-09-24,"JAX","HOU",17,37,-20,"2023"
"5974","2023_03_IND_BAL",2023-09-24,"BAL","IND",19,22,-3,"2023"
"5975","2023_03_LAC_MIN",2023-09-24,"MIN","LAC",24,28,-4,"2023"
"5976","2023_03_LA_CIN",2023-09-25,"CIN","LA",19,16,3,"2023"
"5977","2023_03_NE_NYJ",2023-09-24,"NYJ","NE",10,15,-5,"2023"
"5978","2023_03_NO_GB",2023-09-24,"GB","NO",18,17,1,"2023"
"5979","2023_03_NYG_SF",2023-09-21,"SF","NYG",30,12,18,"2023"
"5980","2023_03_PHI_TB",2023-09-25,"TB","PHI",11,25,-14,"2023"
"5981","2023_03_PIT_LV",2023-09-24,"LV","PIT",18,23,-5,"2023"
"5982","2023_03_TEN_CLE",2023-09-24,"CLE","TEN",27,3,24,"2023"
"5983","2023_04_ARI_SF",2023-10-01,"SF","ARI",35,16,19,"2023"
"5984","2023_04_ATL_JAX",2023-10-01,"JAX","ATL",23,7,16,"2023"
"5985","2023_04_BAL_CLE",2023-10-01,"CLE","BAL",3,28,-25,"2023"
"5986","2023_04_CIN_TEN",2023-10-01,"TEN","CIN",27,3,24,"2023"
"5987","2023_04_DEN_CHI",2023-10-01,"CHI","DEN",28,31,-3,"2023"
"5988","2023_04_DET_GB",2023-09-28,"GB","DET",20,34,-14,"2023"
"5989","2023_04_KC_NYJ",2023-10-01,"NYJ","KC",20,23,-3,"2023"
"5990","2023_04_LA_IND",2023-10-01,"IND","LA",23,29,-6,"2023"
"5991","2023_04_LV_LAC",2023-10-01,"LAC","LV",24,17,7,"2023"
"5992","2023_04_MIA_BUF",2023-10-01,"BUF","MIA",48,20,28,"2023"
"5993","2023_04_MIN_CAR",2023-10-01,"CAR","MIN",13,21,-8,"2023"
"5994","2023_04_NE_DAL",2023-10-01,"DAL","NE",38,3,35,"2023"
"5995","2023_04_PIT_HOU",2023-10-01,"HOU","PIT",30,6,24,"2023"
"5996","2023_04_SEA_NYG",2023-10-02,"NYG","SEA",3,24,-21,"2023"
"5997","2023_04_TB_NO",2023-10-01,"NO","TB",9,26,-17,"2023"
"5998","2023_04_WAS_PHI",2023-10-01,"PHI","WAS",34,31,3,"2023"
"5999","2023_05_BAL_PIT",2023-10-08,"PIT","BAL",17,10,7,"2023"
"6000","2023_05_CAR_DET",2023-10-08,"DET","CAR",42,24,18,"2023"
"6001","2023_05_CHI_WAS",2023-10-05,"WAS","CHI",20,40,-20,"2023"
"6002","2023_05_CIN_ARI",2023-10-08,"ARI","CIN",20,34,-14,"2023"
"6003","2023_05_DAL_SF",2023-10-08,"SF","DAL",42,10,32,"2023"
"6004","2023_05_GB_LV",2023-10-09,"LV","GB",17,13,4,"2023"
"6005","2023_05_HOU_ATL",2023-10-08,"ATL","HOU",21,19,2,"2023"
"6006","2023_05_JAX_BUF",2023-10-08,"BUF","JAX",20,25,-5,"2023"
"6007","2023_05_KC_MIN",2023-10-08,"MIN","KC",20,27,-7,"2023"
"6008","2023_05_NO_NE",2023-10-08,"NE","NO",0,34,-34,"2023"
"6009","2023_05_NYG_MIA",2023-10-08,"MIA","NYG",31,16,15,"2023"
"6010","2023_05_NYJ_DEN",2023-10-08,"DEN","NYJ",21,31,-10,"2023"
"6011","2023_05_PHI_LA",2023-10-08,"LA","PHI",14,23,-9,"2023"
"6012","2023_05_TEN_IND",2023-10-08,"IND","TEN",23,16,7,"2023"
"6013","2023_06_ARI_LA",2023-10-15,"LA","ARI",26,9,17,"2023"
"6014","2023_06_BAL_TEN",2023-10-15,"TEN","BAL",16,24,-8,"2023"
"6015","2023_06_CAR_MIA",2023-10-15,"MIA","CAR",42,21,21,"2023"
"6016","2023_06_DAL_LAC",2023-10-16,"LAC","DAL",17,20,-3,"2023"
"6017","2023_06_DEN_KC",2023-10-12,"KC","DEN",19,8,11,"2023"
"6018","2023_06_DET_TB",2023-10-15,"TB","DET",6,20,-14,"2023"
"6019","2023_06_IND_JAX",2023-10-15,"JAX","IND",37,20,17,"2023"
"6020","2023_06_MIN_CHI",2023-10-15,"CHI","MIN",13,19,-6,"2023"
"6021","2023_06_NE_LV",2023-10-15,"LV","NE",21,17,4,"2023"
"6022","2023_06_NO_HOU",2023-10-15,"HOU","NO",20,13,7,"2023"
"6023","2023_06_NYG_BUF",2023-10-15,"BUF","NYG",14,9,5,"2023"
"6024","2023_06_PHI_NYJ",2023-10-15,"NYJ","PHI",20,14,6,"2023"
"6025","2023_06_SEA_CIN",2023-10-15,"CIN","SEA",17,13,4,"2023"
"6026","2023_06_SF_CLE",2023-10-15,"CLE","SF",19,17,2,"2023"
"6027","2023_06_WAS_ATL",2023-10-15,"ATL","WAS",16,24,-8,"2023"
"6028","2023_07_ARI_SEA",2023-10-22,"SEA","ARI",20,10,10,"2023"
"6029","2023_07_ATL_TB",2023-10-22,"TB","ATL",13,16,-3,"2023"
"6030","2023_07_BUF_NE",2023-10-22,"NE","BUF",29,25,4,"2023"
"6031","2023_07_CLE_IND",2023-10-22,"IND","CLE",38,39,-1,"2023"
"6032","2023_07_DET_BAL",2023-10-22,"BAL","DET",38,6,32,"2023"
"6033","2023_07_GB_DEN",2023-10-22,"DEN","GB",19,17,2,"2023"
"6034","2023_07_JAX_NO",2023-10-19,"NO","JAX",24,31,-7,"2023"
"6035","2023_07_LAC_KC",2023-10-22,"KC","LAC",31,17,14,"2023"
"6036","2023_07_LV_CHI",2023-10-22,"CHI","LV",30,12,18,"2023"
"6037","2023_07_MIA_PHI",2023-10-22,"PHI","MIA",31,17,14,"2023"
"6038","2023_07_PIT_LA",2023-10-22,"LA","PIT",17,24,-7,"2023"
"6039","2023_07_SF_MIN",2023-10-23,"MIN","SF",22,17,5,"2023"
"6040","2023_07_WAS_NYG",2023-10-22,"NYG","WAS",14,7,7,"2023"
"6041","2023_08_ATL_TEN",2023-10-29,"TEN","ATL",28,23,5,"2023"
"6042","2023_08_BAL_ARI",2023-10-29,"ARI","BAL",24,31,-7,"2023"
"6043","2023_08_CHI_LAC",2023-10-29,"LAC","CHI",30,13,17,"2023"
"6044","2023_08_CIN_SF",2023-10-29,"SF","CIN",17,31,-14,"2023"
"6045","2023_08_CLE_SEA",2023-10-29,"SEA","CLE",24,20,4,"2023"
"6046","2023_08_HOU_CAR",2023-10-29,"CAR","HOU",15,13,2,"2023"
"6047","2023_08_JAX_PIT",2023-10-29,"PIT","JAX",10,20,-10,"2023"
"6048","2023_08_KC_DEN",2023-10-29,"DEN","KC",24,9,15,"2023"
"6049","2023_08_LA_DAL",2023-10-29,"DAL","LA",43,20,23,"2023"
"6050","2023_08_LV_DET",2023-10-30,"DET","LV",26,14,12,"2023"
"6051","2023_08_MIN_GB",2023-10-29,"GB","MIN",10,24,-14,"2023"
"6052","2023_08_NE_MIA",2023-10-29,"MIA","NE",31,17,14,"2023"
"6053","2023_08_NO_IND",2023-10-29,"IND","NO",27,38,-11,"2023"
"6054","2023_08_NYJ_NYG",2023-10-29,"NYG","NYJ",10,13,-3,"2023"
"6055","2023_08_PHI_WAS",2023-10-29,"WAS","PHI",31,38,-7,"2023"
"6056","2023_08_TB_BUF",2023-10-26,"BUF","TB",24,18,6,"2023"
"6057","2023_09_ARI_CLE",2023-11-05,"CLE","ARI",27,0,27,"2023"
"6058","2023_09_BUF_CIN",2023-11-05,"CIN","BUF",24,18,6,"2023"
"6059","2023_09_CHI_NO",2023-11-05,"NO","CHI",24,17,7,"2023"
"6060","2023_09_DAL_PHI",2023-11-05,"PHI","DAL",28,23,5,"2023"
"6061","2023_09_IND_CAR",2023-11-05,"CAR","IND",13,27,-14,"2023"
"6062","2023_09_LAC_NYJ",2023-11-06,"NYJ","LAC",6,27,-21,"2023"
"6063","2023_09_LA_GB",2023-11-05,"GB","LA",20,3,17,"2023"
"6064","2023_09_MIA_KC",2023-11-05,"KC","MIA",21,14,7,"2023"
"6065","2023_09_MIN_ATL",2023-11-05,"ATL","MIN",28,31,-3,"2023"
"6066","2023_09_NYG_LV",2023-11-05,"LV","NYG",30,6,24,"2023"
"6067","2023_09_SEA_BAL",2023-11-05,"BAL","SEA",37,3,34,"2023"
"6068","2023_09_TB_HOU",2023-11-05,"HOU","TB",39,37,2,"2023"
"6069","2023_09_TEN_PIT",2023-11-02,"PIT","TEN",20,16,4,"2023"
"6070","2023_09_WAS_NE",2023-11-05,"NE","WAS",17,20,-3,"2023"
"6071","2023_10_ATL_ARI",2023-11-12,"ARI","ATL",25,23,2,"2023"
"6072","2023_10_CAR_CHI",2023-11-09,"CHI","CAR",16,13,3,"2023"
"6073","2023_10_CLE_BAL",2023-11-12,"BAL","CLE",31,33,-2,"2023"
"6074","2023_10_DEN_BUF",2023-11-13,"BUF","DEN",22,24,-2,"2023"
"6075","2023_10_DET_LAC",2023-11-12,"LAC","DET",38,41,-3,"2023"
"6076","2023_10_GB_PIT",2023-11-12,"PIT","GB",23,19,4,"2023"
"6077","2023_10_HOU_CIN",2023-11-12,"CIN","HOU",27,30,-3,"2023"
"6078","2023_10_IND_NE",2023-11-12,"NE","IND",6,10,-4,"2023"
"6079","2023_10_NO_MIN",2023-11-12,"MIN","NO",27,19,8,"2023"
"6080","2023_10_NYG_DAL",2023-11-12,"DAL","NYG",49,17,32,"2023"
"6081","2023_10_NYJ_LV",2023-11-12,"LV","NYJ",16,12,4,"2023"
"6082","2023_10_SF_JAX",2023-11-12,"JAX","SF",3,34,-31,"2023"
"6083","2023_10_TEN_TB",2023-11-12,"TB","TEN",20,6,14,"2023"
"6084","2023_10_WAS_SEA",2023-11-12,"SEA","WAS",29,26,3,"2023"
"6085","2023_11_ARI_HOU",2023-11-19,"HOU","ARI",21,16,5,"2023"
"6086","2023_11_CHI_DET",2023-11-19,"DET","CHI",31,26,5,"2023"
"6087","2023_11_CIN_BAL",2023-11-16,"BAL","CIN",34,20,14,"2023"
"6088","2023_11_DAL_CAR",2023-11-19,"CAR","DAL",10,33,-23,"2023"
"6089","2023_11_LAC_GB",2023-11-19,"GB","LAC",23,20,3,"2023"
"6090","2023_11_LV_MIA",2023-11-19,"MIA","LV",20,13,7,"2023"
"6091","2023_11_MIN_DEN",2023-11-19,"DEN","MIN",21,20,1,"2023"
"6092","2023_11_NYG_WAS",2023-11-19,"WAS","NYG",19,31,-12,"2023"
"6093","2023_11_NYJ_BUF",2023-11-19,"BUF","NYJ",32,6,26,"2023"
"6094","2023_11_PHI_KC",2023-11-20,"KC","PHI",17,21,-4,"2023"
"6095","2023_11_PIT_CLE",2023-11-19,"CLE","PIT",13,10,3,"2023"
"6096","2023_11_SEA_LA",2023-11-19,"LA","SEA",17,16,1,"2023"
"6097","2023_11_TB_SF",2023-11-19,"SF","TB",27,14,13,"2023"
"6098","2023_11_TEN_JAX",2023-11-19,"JAX","TEN",34,14,20,"2023"
"6099","2023_12_BAL_LAC",2023-11-26,"LAC","BAL",10,20,-10,"2023"
"6100","2023_12_BUF_PHI",2023-11-26,"PHI","BUF",37,34,3,"2023"
"6101","2023_12_CAR_TEN",2023-11-26,"TEN","CAR",17,10,7,"2023"
"6102","2023_12_CHI_MIN",2023-11-27,"MIN","CHI",10,12,-2,"2023"
"6103","2023_12_CLE_DEN",2023-11-26,"DEN","CLE",29,12,17,"2023"
"6104","2023_12_GB_DET",2023-11-23,"DET","GB",22,29,-7,"2023"
"6105","2023_12_JAX_HOU",2023-11-26,"HOU","JAX",21,24,-3,"2023"
"6106","2023_12_KC_LV",2023-11-26,"LV","KC",17,31,-14,"2023"
"6107","2023_12_LA_ARI",2023-11-26,"ARI","LA",14,37,-23,"2023"
"6108","2023_12_MIA_NYJ",2023-11-24,"NYJ","MIA",13,34,-21,"2023"
"6109","2023_12_NE_NYG",2023-11-26,"NYG","NE",10,7,3,"2023"
"6110","2023_12_NO_ATL",2023-11-26,"ATL","NO",24,15,9,"2023"
"6111","2023_12_PIT_CIN",2023-11-26,"CIN","PIT",10,16,-6,"2023"
"6112","2023_12_SF_SEA",2023-11-23,"SEA","SF",13,31,-18,"2023"
"6113","2023_12_TB_IND",2023-11-26,"IND","TB",27,20,7,"2023"
"6114","2023_12_WAS_DAL",2023-11-23,"DAL","WAS",45,10,35,"2023"
"6115","2023_13_ARI_PIT",2023-12-03,"PIT","ARI",10,24,-14,"2023"
"6116","2023_13_ATL_NYJ",2023-12-03,"NYJ","ATL",8,13,-5,"2023"
"6117","2023_13_CAR_TB",2023-12-03,"TB","CAR",21,18,3,"2023"
"6118","2023_13_CIN_JAX",2023-12-04,"JAX","CIN",31,34,-3,"2023"
"6119","2023_13_CLE_LA",2023-12-03,"LA","CLE",36,19,17,"2023"
"6120","2023_13_DEN_HOU",2023-12-03,"HOU","DEN",22,17,5,"2023"
"6121","2023_13_DET_NO",2023-12-03,"NO","DET",28,33,-5,"2023"
"6122","2023_13_IND_TEN",2023-12-03,"TEN","IND",28,31,-3,"2023"
"6123","2023_13_KC_GB",2023-12-03,"GB","KC",27,19,8,"2023"
"6124","2023_13_LAC_NE",2023-12-03,"NE","LAC",0,6,-6,"2023"
"6125","2023_13_MIA_WAS",2023-12-03,"WAS","MIA",15,45,-30,"2023"
"6126","2023_13_SEA_DAL",2023-11-30,"DAL","SEA",41,35,6,"2023"
"6127","2023_13_SF_PHI",2023-12-03,"PHI","SF",19,42,-23,"2023"
"6128","2023_14_BUF_KC",2023-12-10,"KC","BUF",17,20,-3,"2023"
"6129","2023_14_CAR_NO",2023-12-10,"NO","CAR",28,6,22,"2023"
"6130","2023_14_DEN_LAC",2023-12-10,"LAC","DEN",7,24,-17,"2023"
"6131","2023_14_DET_CHI",2023-12-10,"CHI","DET",28,13,15,"2023"
"6132","2023_14_GB_NYG",2023-12-11,"NYG","GB",24,22,2,"2023"
"6133","2023_14_HOU_NYJ",2023-12-10,"NYJ","HOU",30,6,24,"2023"
"6134","2023_14_IND_CIN",2023-12-10,"CIN","IND",34,14,20,"2023"
"6135","2023_14_JAX_CLE",2023-12-10,"CLE","JAX",31,27,4,"2023"
"6136","2023_14_LA_BAL",2023-12-10,"BAL","LA",37,31,6,"2023"
"6137","2023_14_MIN_LV",2023-12-10,"LV","MIN",0,3,-3,"2023"
"6138","2023_14_NE_PIT",2023-12-07,"PIT","NE",18,21,-3,"2023"
"6139","2023_14_PHI_DAL",2023-12-10,"DAL","PHI",33,13,20,"2023"
"6140","2023_14_SEA_SF",2023-12-10,"SF","SEA",28,16,12,"2023"
"6141","2023_14_TB_ATL",2023-12-10,"ATL","TB",25,29,-4,"2023"
"6142","2023_14_TEN_MIA",2023-12-11,"MIA","TEN",27,28,-1,"2023"
"6143","2023_15_ATL_CAR",2023-12-17,"CAR","ATL",9,7,2,"2023"
"6144","2023_15_BAL_JAX",2023-12-17,"JAX","BAL",7,23,-16,"2023"
"6145","2023_15_CHI_CLE",2023-12-17,"CLE","CHI",20,17,3,"2023"
"6146","2023_15_DAL_BUF",2023-12-17,"BUF","DAL",31,10,21,"2023"
"6147","2023_15_DEN_DET",2023-12-16,"DET","DEN",42,17,25,"2023"
"6148","2023_15_HOU_TEN",2023-12-17,"TEN","HOU",16,19,-3,"2023"
"6149","2023_15_KC_NE",2023-12-17,"NE","KC",17,27,-10,"2023"
"6150","2023_15_LAC_LV",2023-12-14,"LV","LAC",63,21,42,"2023"
"6151","2023_15_MIN_CIN",2023-12-16,"CIN","MIN",27,24,3,"2023"
"6152","2023_15_NYG_NO",2023-12-17,"NO","NYG",24,6,18,"2023"
"6153","2023_15_NYJ_MIA",2023-12-17,"MIA","NYJ",30,0,30,"2023"
"6154","2023_15_PHI_SEA",2023-12-18,"SEA","PHI",20,17,3,"2023"
"6155","2023_15_PIT_IND",2023-12-16,"IND","PIT",30,13,17,"2023"
"6156","2023_15_SF_ARI",2023-12-17,"ARI","SF",29,45,-16,"2023"
"6157","2023_15_TB_GB",2023-12-17,"GB","TB",20,34,-14,"2023"
"6158","2023_15_WAS_LA",2023-12-17,"LA","WAS",28,20,8,"2023"
"6159","2023_16_ARI_CHI",2023-12-24,"CHI","ARI",27,16,11,"2023"
"6160","2023_16_BAL_SF",2023-12-25,"SF","BAL",19,33,-14,"2023"
"6161","2023_16_BUF_LAC",2023-12-23,"LAC","BUF",22,24,-2,"2023"
"6162","2023_16_CIN_PIT",2023-12-23,"PIT","CIN",34,11,23,"2023"
"6163","2023_16_CLE_HOU",2023-12-24,"HOU","CLE",22,36,-14,"2023"
"6164","2023_16_DAL_MIA",2023-12-24,"MIA","DAL",22,20,2,"2023"
"6165","2023_16_DET_MIN",2023-12-24,"MIN","DET",24,30,-6,"2023"
"6166","2023_16_GB_CAR",2023-12-24,"CAR","GB",30,33,-3,"2023"
"6167","2023_16_IND_ATL",2023-12-24,"ATL","IND",29,10,19,"2023"
"6168","2023_16_JAX_TB",2023-12-24,"TB","JAX",30,12,18,"2023"
"6169","2023_16_LV_KC",2023-12-25,"KC","LV",14,20,-6,"2023"
"6170","2023_16_NE_DEN",2023-12-24,"DEN","NE",23,26,-3,"2023"
"6171","2023_16_NO_LA",2023-12-21,"LA","NO",30,22,8,"2023"
"6172","2023_16_NYG_PHI",2023-12-25,"PHI","NYG",33,25,8,"2023"
"6173","2023_16_SEA_TEN",2023-12-24,"TEN","SEA",17,20,-3,"2023"
"6174","2023_16_WAS_NYJ",2023-12-24,"NYJ","WAS",30,28,2,"2023"
"6175","2023_17_ARI_PHI",2023-12-31,"PHI","ARI",31,35,-4,"2023"
"6176","2023_17_ATL_CHI",2023-12-31,"CHI","ATL",37,17,20,"2023"
"6177","2023_17_CAR_JAX",2023-12-31,"JAX","CAR",26,0,26,"2023"
"6178","2023_17_CIN_KC",2023-12-31,"KC","CIN",25,17,8,"2023"
"6179","2023_17_DET_DAL",2023-12-30,"DAL","DET",20,19,1,"2023"
"6180","2023_17_GB_MIN",2023-12-31,"MIN","GB",10,33,-23,"2023"
"6181","2023_17_LAC_DEN",2023-12-31,"DEN","LAC",16,9,7,"2023"
"6182","2023_17_LA_NYG",2023-12-31,"NYG","LA",25,26,-1,"2023"
"6183","2023_17_LV_IND",2023-12-31,"IND","LV",23,20,3,"2023"
"6184","2023_17_MIA_BAL",2023-12-31,"BAL","MIA",56,19,37,"2023"
"6185","2023_17_NE_BUF",2023-12-31,"BUF","NE",27,21,6,"2023"
"6186","2023_17_NO_TB",2023-12-31,"TB","NO",13,23,-10,"2023"
"6187","2023_17_NYJ_CLE",2023-12-28,"CLE","NYJ",37,20,17,"2023"
"6188","2023_17_PIT_SEA",2023-12-31,"SEA","PIT",23,30,-7,"2023"
"6189","2023_17_SF_WAS",2023-12-31,"WAS","SF",10,27,-17,"2023"
"6190","2023_17_TEN_HOU",2023-12-31,"HOU","TEN",26,3,23,"2023"
"6191","2024_01_ARI_BUF",2024-09-08,"BUF","ARI",34,28,6,"2024"
"6192","2024_01_BAL_KC",2024-09-05,"KC","BAL",27,20,7,"2024"
"6193","2024_01_CAR_NO",2024-09-08,"NO","CAR",47,10,37,"2024"
"6194","2024_01_DAL_CLE",2024-09-08,"CLE","DAL",17,33,-16,"2024"
"6195","2024_01_DEN_SEA",2024-09-08,"SEA","DEN",26,20,6,"2024"
"6196","2024_01_GB_PHI",2024-09-06,"PHI","GB",34,29,5,"2024"
"6197","2024_01_HOU_IND",2024-09-08,"IND","HOU",27,29,-2,"2024"
"6198","2024_01_JAX_MIA",2024-09-08,"MIA","JAX",20,17,3,"2024"
"6199","2024_01_LA_DET",2024-09-08,"DET","LA",26,20,6,"2024"
"6200","2024_01_LV_LAC",2024-09-08,"LAC","LV",22,10,12,"2024"
"6201","2024_01_MIN_NYG",2024-09-08,"NYG","MIN",6,28,-22,"2024"
"6202","2024_01_NE_CIN",2024-09-08,"CIN","NE",10,16,-6,"2024"
"6203","2024_01_NYJ_SF",2024-09-09,"SF","NYJ",32,19,13,"2024"
"6204","2024_01_PIT_ATL",2024-09-08,"ATL","PIT",10,18,-8,"2024"
"6205","2024_01_TEN_CHI",2024-09-08,"CHI","TEN",24,17,7,"2024"
"6206","2024_01_WAS_TB",2024-09-08,"TB","WAS",37,20,17,"2024"
"6207","2024_02_ATL_PHI",2024-09-16,"PHI","ATL",21,22,-1,"2024"
"6208","2024_02_BUF_MIA",2024-09-12,"MIA","BUF",10,31,-21,"2024"
"6209","2024_02_CHI_HOU",2024-09-15,"HOU","CHI",19,13,6,"2024"
"6210","2024_02_CIN_KC",2024-09-15,"KC","CIN",26,25,1,"2024"
"6211","2024_02_CLE_JAX",2024-09-15,"JAX","CLE",13,18,-5,"2024"
"6212","2024_02_IND_GB",2024-09-15,"GB","IND",16,10,6,"2024"
"6213","2024_02_LAC_CAR",2024-09-15,"CAR","LAC",3,26,-23,"2024"
"6214","2024_02_LA_ARI",2024-09-15,"ARI","LA",41,10,31,"2024"
"6215","2024_02_LV_BAL",2024-09-15,"BAL","LV",23,26,-3,"2024"
"6216","2024_02_NO_DAL",2024-09-15,"DAL","NO",19,44,-25,"2024"
"6217","2024_02_NYG_WAS",2024-09-15,"WAS","NYG",21,18,3,"2024"
"6218","2024_02_NYJ_TEN",2024-09-15,"TEN","NYJ",17,24,-7,"2024"
"6219","2024_02_PIT_DEN",2024-09-15,"DEN","PIT",6,13,-7,"2024"
"6220","2024_02_SEA_NE",2024-09-15,"NE","SEA",20,23,-3,"2024"
"6221","2024_02_SF_MIN",2024-09-15,"MIN","SF",23,17,6,"2024"
"6222","2024_02_TB_DET",2024-09-15,"DET","TB",16,20,-4,"2024"
